Team,GameNumber,Date,Opponent,Home,TeamWin,TeamScr,OppScr,GameType,Min,Pts,Reb,Ast,Stl,Blk,To,Pf,Dreb,Oreb,Fgm,Fga,fg3m,fg3a,Fg2m,Fg2a,Ftm,Fta,eff
Miami,1,"October 26, 2016",Orlando,0,1,108,96,1,48,108,52,27,5,7,10,22,36,16,47,97,4,16,43,81,10,16,133
Golden State,1,"October 25, 2016",San Antonio,1,0,100,129,1,48,100,35,24,11,6,16,19,27,8,40,85,7,33,33,52,13,18,110
Washington,1,"October 27, 2016",Atlanta,0,0,99,114,1,48,99,40,25,14,4,19,20,28,12,40,94,6,20,34,74,13,18,104
Dallas,1,"October 26, 2016",Indiana,0,0,121,130,1,53,121,49,26,8,8,15,27,39,10,45,104,18,48,27,56,13,18,133
Atlanta,1,"October 27, 2016",Washington,1,1,114,99,1,48,114,52,28,13,7,21,19,38,14,44,88,12,26,32,62,14,18,145
Cleveland,1,"October 25, 2016",New York,1,1,117,88,1,48,117,51,31,12,5,14,22,40,11,45,94,13,35,32,59,14,19,148
Boston,1,"October 26, 2016",Brooklyn,1,1,122,117,1,48,122,47,36,13,9,19,20,35,12,48,89,11,32,37,57,15,18,164
Milwaukee,1,"October 26, 2016",Charlotte,1,0,96,107,1,48,96,46,23,4,5,8,22,36,10,39,92,3,16,36,76,15,20,108
New York,1,"October 25, 2016",Cleveland,0,0,88,117,1,48,88,42,17,6,6,18,22,29,13,32,87,9,27,23,60,15,20,81
Utah,1,"October 25, 2016",Portland,0,0,104,113,1,48,104,31,19,9,5,11,19,25,6,40,82,8,24,32,58,16,16,115
Brooklyn,1,"October 26, 2016",Boston,0,0,117,122,1,48,117,44,22,8,3,16,19,29,15,43,97,15,44,28,53,16,20,120
Detroit,1,"October 26, 2016",Toronto,0,0,91,109,1,48,91,40,17,8,0,13,24,32,8,35,84,4,22,31,62,17,22,89
L.A. Lakers,1,"October 26, 2016",Houston,1,1,120,114,1,48,120,39,21,10,4,15,24,28,11,45,89,12,35,33,54,18,22,131
Philadelphia,1,"October 26, 2016",Oklahoma City,1,0,97,103,1,48,97,43,21,5,10,13,22,38,5,36,84,7,24,29,60,18,25,108
Phoenix,1,"October 26, 2016",Sacramento,1,0,94,113,1,48,94,41,20,6,3,18,29,31,10,36,77,4,16,32,61,18,27,96
Sacramento,1,"October 26, 2016",Phoenix,0,1,113,94,1,48,113,41,24,5,5,13,20,31,10,44,86,6,21,38,65,19,26,126
Oklahoma City,1,"October 26, 2016",Philadelphia,0,1,103,97,1,48,103,53,19,7,3,10,23,40,13,39,94,6,22,33,72,19,26,113
Houston,1,"October 26, 2016",L.A.Lakers,0,0,114,120,1,48,114,39,29,10,1,14,23,29,10,44,86,7,29,37,57,19,27,129
Memphis,1,"October 26, 2016",Minnesota,1,1,102,98,1,48,102,45,19,6,11,13,25,34,11,36,80,11,24,25,56,19,27,118
Charlotte,1,"October 26, 2016",Milwaukee,0,1,107,96,1,48,107,51,27,5,10,10,22,40,11,40,89,7,23,33,66,20,24,137
Minnesota,1,"October 26, 2016",Memphis,0,0,98,102,1,48,98,45,20,6,5,10,23,30,15,36,86,6,18,30,68,20,29,105
Portland,1,"October 25, 2016",Utah,1,1,113,104,1,48,113,34,22,5,3,12,18,29,5,39,75,13,19,26,56,22,22,129
Orlando,1,"October 26, 2016",Miami,1,0,96,108,1,48,96,44,20,5,4,11,15,30,14,34,88,6,17,28,71,22,28,98
Chicago,1,"October 27, 2016",Boston,1,1,105,99,1,48,105,55,25,5,1,12,21,37,18,36,92,11,25,25,67,22,30,115
New Orleans,1,"October 26, 2016",Denver,1,0,102,107,1,48,102,34,31,16,5,11,29,29,5,38,92,3,19,35,73,23,26,120
San Antonio,1,"October 25, 2016",Golden State,0,1,129,100,1,48,129,55,25,13,3,13,19,34,21,47,98,12,24,35,74,23,26,158
Toronto,1,"October 26, 2016",Detroit,1,1,109,91,1,48,109,51,17,8,0,11,22,37,14,41,86,3,18,38,68,24,29,124
Denver,1,"October 26, 2016",New Orleans,0,1,107,102,1,48,107,58,18,7,2,24,22,47,11,37,83,8,24,29,59,25,33,114
Indiana,1,"October 26, 2016",Dallas,1,1,130,121,1,53,130,52,30,11,6,16,23,44,8,47,93,10,19,37,74,26,34,159
L.A. Clippers,1,"October 27, 2016",Portland,0,1,114,106,1,48,114,48,12,10,4,7,25,33,15,37,91,8,29,29,62,32,46,113
Detroit,2,"October 28, 2016",Orlando,1,1,108,82,1,48,108,53,27,8,4,12,11,44,9,48,95,7,19,41,76,5,6,140
Orlando,2,"October 28, 2016",Detroit,0,0,82,108,1,48,82,44,20,8,3,9,13,30,14,33,95,8,26,25,69,8,12,82
Philadelphia,2,"October 29, 2016",Atlanta,1,0,72,104,1,48,72,39,16,9,5,20,20,35,4,28,80,5,18,23,62,11,15,65
Indiana,2,"October 28, 2016",Brooklyn,0,0,94,103,1,48,94,49,22,7,6,13,22,35,14,37,98,7,24,30,74,13,20,97
Miami,2,"October 28, 2016",Charlotte,1,0,91,97,1,48,91,52,19,2,4,19,23,41,11,32,86,14,34,18,52,13,20,88
L.A. Clippers,2,"October 30, 2016",Utah,1,1,88,75,1,48,88,49,17,8,4,13,14,35,14,34,83,6,27,28,56,14,20,98
Atlanta,2,"October 29, 2016",Philadelphia,0,1,104,72,1,48,104,47,31,11,7,12,14,41,6,42,85,5,20,37,65,15,23,137
New Orleans,2,"October 28, 2016",Golden State,1,0,114,122,1,48,114,49,29,8,6,13,24,37,12,47,100,5,22,42,78,15,23,132
Boston,2,"October 27, 2016",Chicago,0,0,99,105,1,48,99,36,22,6,6,11,25,33,3,38,76,8,23,30,53,15,24,111
L.A. Lakers,2,"October 28, 2016",Utah,0,0,89,96,1,48,89,43,16,6,7,14,29,32,11,32,84,9,23,23,61,16,21,90
Cleveland,2,"October 28, 2016",Toronto,0,1,94,91,1,48,94,40,20,8,3,17,15,31,9,33,79,12,32,21,47,16,22,96
Toronto,2,"October 28, 2016",Cleveland,1,0,91,94,1,48,91,51,12,9,3,18,20,33,18,35,90,4,16,31,74,17,18,92
Brooklyn,2,"October 28, 2016",Indiana,1,1,103,94,1,48,103,52,20,6,4,16,23,40,12,38,87,10,33,28,54,17,20,117
Chicago,2,"October 29, 2016",Indiana,1,1,118,101,1,48,118,47,34,8,6,12,14,34,13,45,86,9,21,36,65,19,21,158
Charlotte,2,"October 28, 2016",Miami,0,1,97,91,1,48,97,49,20,10,9,8,20,36,13,35,92,7,22,28,70,20,24,116
Milwaukee,2,"October 29, 2016",Brooklyn,1,1,110,108,1,48,110,45,25,14,5,14,24,36,9,41,88,8,22,33,66,20,24,134
Dallas,2,"October 28, 2016",Houston,1,0,98,106,1,48,98,34,13,11,2,9,21,28,6,35,80,8,29,27,51,20,24,100
Memphis,2,"October 29, 2016",New York,0,0,104,111,1,48,104,40,19,3,2,12,30,29,11,37,86,9,25,28,61,21,26,102
Phoenix,2,"October 28, 2016",Oklahoma City,0,0,110,113,1,53,110,44,15,11,3,15,29,37,7,42,94,5,28,37,66,21,32,105
Washington,2,"October 30, 2016",Memphis,0,0,103,112,1,53,103,40,19,8,4,14,23,32,8,38,86,5,25,33,61,22,25,109
Minnesota,2,"October 29, 2016",Sacramento,0,0,103,106,1,48,103,38,19,5,5,11,25,29,9,37,72,7,22,30,50,22,31,115
San Antonio,2,"October 27, 2016",Sacramento,0,1,102,94,1,48,102,40,23,10,8,9,26,31,9,36,79,6,18,30,61,24,27,128
Portland,2,"October 27, 2016",L.A.Clippers,1,0,106,114,1,48,106,48,18,4,4,14,34,39,9,39,85,4,18,35,67,24,32,112
Golden State,2,"October 28, 2016",New Orleans,0,1,122,114,1,48,122,49,32,8,2,14,22,40,9,44,91,9,28,35,63,25,28,149
Houston,2,"October 28, 2016",Dallas,0,1,106,98,1,48,106,41,21,6,1,18,22,36,5,33,70,15,32,18,38,25,31,114
New York,2,"October 29, 2016",Memphis,1,1,111,104,1,48,111,41,24,4,4,12,25,35,6,40,76,6,21,34,55,25,39,122
Oklahoma City,2,"October 28, 2016",Phoenix,1,1,113,110,1,53,113,57,13,11,3,22,24,43,14,40,96,5,21,35,75,28,38,109
Utah,2,"October 28, 2016",L.A.Lakers,1,1,96,89,1,48,96,47,14,4,7,14,18,34,13,31,75,6,25,25,50,28,40,98
Denver,2,"October 29, 2016",Portland,1,0,113,115,1,53,113,61,19,10,5,17,21,45,16,38,100,6,23,32,77,31,39,121
Sacramento,2,"October 27, 2016",San Antonio,1,0,94,102,1,48,94,40,22,7,0,15,21,34,6,28,70,6,20,22,50,32,38,100
Indiana,3,"October 29, 2016",Chicago,0,0,101,118,1,48,101,33,34,8,7,13,16,25,8,43,88,7,18,36,70,8,9,124
Utah,3,"October 30, 2016",L.A.Clippers,0,0,75,88,1,48,75,43,18,8,3,18,22,36,7,29,73,7,19,22,54,10,13,82
Milwaukee,3,"October 30, 2016",Detroit,0,0,83,98,1,48,83,40,22,10,4,12,16,30,10,34,87,4,17,30,70,11,14,91
New Orleans,3,"October 29, 2016",San Antonio,0,0,79,98,1,48,79,45,14,6,5,9,19,38,7,32,86,4,22,28,64,11,15,82
Boston,3,"October 29, 2016",Charlotte,0,1,104,98,1,48,104,42,25,4,6,13,26,38,4,39,81,15,31,24,50,11,17,120
New York,3,"November 1, 2016",Detroit,0,0,89,102,1,48,89,43,18,6,9,11,20,35,8,35,86,7,22,28,64,12,15,100
Philadelphia,3,"November 1, 2016",Orlando,1,0,101,103,1,48,101,42,28,5,8,15,20,35,7,40,82,9,21,31,61,12,16,123
Oklahoma City,3,"October 30, 2016",L.A.Lakers,1,1,113,96,1,48,113,46,29,15,6,19,22,35,11,45,95,9,26,36,69,14,17,137
Houston,3,"October 30, 2016",Dallas,1,1,93,92,1,48,93,46,16,5,4,17,21,37,9,34,80,11,31,23,49,14,21,94
Detroit,3,"October 30, 2016",Milwaukee,1,1,98,83,1,48,98,58,23,8,4,15,14,42,16,39,88,5,20,34,68,15,20,122
Portland,3,"October 29, 2016",Denver,0,1,115,113,1,53,115,45,23,10,8,15,30,40,5,45,98,10,32,35,66,15,21,127
Orlando,3,"October 29, 2016",Cleveland,0,0,99,105,1,48,99,50,21,6,5,20,23,37,13,38,84,8,28,30,56,15,26,104
Washington,3,"November 2, 2016",Toronto,1,0,103,113,1,48,103,36,21,8,5,20,20,30,6,42,72,3,10,39,62,16,24,115
Chicago,3,"October 31, 2016",Brooklyn,0,1,118,88,1,48,118,58,26,9,9,19,22,45,13,45,89,11,27,34,62,17,18,156
Dallas,3,"October 30, 2016",Houston,0,0,92,93,1,48,92,42,17,8,3,9,17,30,12,32,84,11,30,21,54,17,20,98
San Antonio,3,"October 29, 2016",New Orleans,1,1,98,79,1,48,98,50,21,6,7,9,15,44,6,35,83,10,24,25,59,18,23,120
Minnesota,3,"November 1, 2016",Memphis,1,1,116,80,1,48,116,49,29,11,4,21,22,39,10,43,78,12,20,31,58,18,23,148
Phoenix,3,"October 30, 2016",Golden State,1,0,100,106,1,48,100,50,19,10,6,11,26,39,11,37,90,8,23,29,67,18,25,114
Miami,3,"October 30, 2016",San Antonio,1,0,99,106,1,48,99,36,19,7,6,12,24,30,6,37,80,7,20,30,60,18,26,104
L.A. Lakers,3,"October 30, 2016",Oklahoma City,0,0,96,113,1,48,96,41,20,15,2,21,18,30,11,35,87,7,32,28,55,19,24,96
Toronto,3,"October 31, 2016",Denver,1,1,105,102,1,48,105,43,16,7,9,7,28,32,11,41,88,4,16,37,72,19,25,120
Sacramento,3,"October 29, 2016",Minnesota,1,1,106,103,1,48,106,31,24,6,5,13,24,20,11,39,85,9,26,30,59,19,25,107
Memphis,3,"October 30, 2016",Washington,1,1,112,103,1,53,112,47,24,9,2,14,26,36,11,39,88,15,31,24,57,19,26,124
Cleveland,3,"October 29, 2016",Orlando,1,1,105,99,1,48,105,40,17,8,6,9,27,27,13,36,88,11,37,25,51,22,30,107
Brooklyn,3,"October 29, 2016",Milwaukee,0,0,108,110,1,48,108,45,23,12,6,18,22,34,11,37,84,11,35,26,49,23,28,124
Charlotte,3,"October 29, 2016",Boston,1,0,98,104,1,48,98,38,22,8,6,8,17,32,6,32,79,9,32,23,47,25,33,109
Denver,3,"October 31, 2016",Toronto,0,0,102,105,1,48,102,46,14,2,9,8,18,35,11,33,81,9,22,24,59,27,35,109
Golden State,3,"October 30, 2016",Phoenix,0,1,106,100,1,48,106,43,27,6,5,15,23,36,7,35,83,8,29,27,54,28,33,119
Atlanta,3,"October 31, 2016",Sacramento,1,1,106,95,1,48,106,44,24,11,6,13,20,27,17,33,79,11,30,22,49,29,47,114
L.A. Clippers,3,"October 31, 2016",Phoenix,1,1,116,98,1,48,116,44,21,8,4,16,23,39,5,40,80,6,16,34,64,30,38,129
Dallas,4,"November 2, 2016",Utah,0,0,81,97,1,48,81,36,18,4,4,12,20,30,6,33,77,7,26,26,51,8,10,85
L.A. Clippers,4,"November 2, 2016",Oklahoma City,1,0,83,85,1,48,83,41,22,13,5,17,19,33,8,34,87,7,22,27,65,8,18,84
Boston,4,"November 2, 2016",Chicago,1,1,107,100,1,48,107,39,28,10,4,12,24,29,10,41,87,14,32,27,55,11,17,124
Oklahoma City,4,"November 2, 2016",L.A.Clippers,0,1,85,83,1,48,85,52,14,8,4,21,24,42,10,34,84,5,20,29,64,12,20,84
Detroit,4,"November 1, 2016",New York,1,1,102,89,1,48,102,48,19,7,5,10,16,38,10,41,89,8,13,33,76,12,21,114
Philadelphia,4,"November 2, 2016",Charlotte,0,0,93,109,1,48,93,37,23,8,2,17,24,29,8,34,86,12,38,22,48,13,15,92
Orlando,4,"November 1, 2016",Philadelphia,0,1,103,101,1,48,103,39,29,7,6,10,15,27,12,42,93,6,25,36,68,13,17,119
Sacramento,4,"October 31, 2016",Atlanta,0,0,95,106,1,48,95,38,26,10,6,19,34,32,6,36,75,10,23,26,52,13,19,111
Utah,4,"November 1, 2016",San Antonio,0,1,106,91,1,48,106,39,22,5,8,10,20,37,2,38,76,15,31,23,45,15,18,129
Portland,4,"November 1, 2016",Golden State,1,0,104,127,1,48,104,32,23,12,4,18,17,26,6,37,86,14,39,23,47,16,21,103
Brooklyn,4,"October 31, 2016",Chicago,1,0,88,118,1,48,88,45,14,12,3,15,15,29,16,33,96,5,31,28,65,17,21,80
Golden State,4,"November 1, 2016",Portland,0,1,127,104,1,48,127,45,36,14,4,16,19,38,7,50,89,10,26,40,63,17,23,165
New York,4,"November 2, 2016",Houston,1,0,99,118,1,48,99,34,18,10,7,16,22,27,7,37,85,8,20,29,65,17,25,96
Toronto,4,"November 2, 2016",Washington,0,1,113,103,1,48,113,31,21,16,2,13,24,27,4,43,77,10,25,33,52,17,25,128
Houston,4,"November 1, 2016",Cleveland,0,0,120,128,1,48,120,32,30,5,2,7,25,21,11,43,90,17,44,26,46,17,25,127
Denver,4,"November 3, 2016",Minnesota,0,1,102,99,1,48,102,44,24,10,3,20,24,37,7,39,81,6,22,33,59,18,25,114
Charlotte,4,"November 2, 2016",Philadelphia,1,1,109,93,1,48,109,44,25,8,3,15,17,35,9,39,79,13,34,26,45,18,26,126
Milwaukee,4,"November 1, 2016",New Orleans,0,1,117,113,1,48,117,50,30,9,5,15,25,39,11,44,91,10,32,34,59,19,21,147
Minnesota,4,"November 3, 2016",Denver,1,0,99,102,1,48,99,43,20,8,4,16,22,29,14,35,88,9,22,26,66,20,25,100
Miami,4,"November 1, 2016",Sacramento,1,1,108,96,1,53,108,45,24,10,9,15,21,39,6,37,86,13,29,24,57,21,29,124
L.A. Lakers,4,"November 1, 2016",Indiana,0,0,108,115,1,48,108,44,14,8,2,19,25,33,11,40,89,6,28,34,61,22,25,105
San Antonio,4,"October 30, 2016",Miami,0,1,106,99,1,48,106,44,20,4,5,15,26,30,14,37,82,10,18,27,64,22,26,115
Memphis,4,"November 1, 2016",Minnesota,0,0,80,116,1,48,80,32,10,17,4,21,22,24,8,27,74,4,24,23,50,22,29,68
Atlanta,4,"November 2, 2016",L.A.Lakers,1,0,116,123,1,48,116,37,30,10,1,18,19,27,10,41,85,11,32,30,53,23,29,126
Indiana,4,"November 1, 2016",L.A.Lakers,1,1,115,108,1,48,115,43,19,10,8,15,20,32,11,41,87,10,28,31,59,23,29,128
Phoenix,4,"October 31, 2016",L.A.Clippers,0,0,98,116,1,48,98,44,19,11,0,20,33,34,10,35,84,5,15,30,69,23,31,95
Chicago,4,"November 2, 2016",Boston,0,0,100,107,1,48,100,49,21,7,7,19,19,34,15,35,81,7,20,28,61,23,31,111
Cleveland,4,"November 1, 2016",Houston,1,1,128,120,1,48,128,46,22,4,2,11,21,34,12,43,83,16,32,27,51,26,31,146
Washington,4,"November 4, 2016",Atlanta,1,1,95,92,1,48,95,46,13,7,3,19,23,35,11,31,80,5,20,26,60,28,35,89
New Orleans,4,"November 1, 2016",Milwaukee,1,0,113,117,1,48,113,42,23,13,5,13,17,33,9,36,82,9,26,27,56,32,41,128
Philadelphia,5,"November 5, 2016",Cleveland,1,0,101,102,1,48,101,45,21,9,9,17,23,40,5,40,87,14,38,26,49,7,12,116
Miami,5,"November 4, 2016",Toronto,0,0,87,96,1,48,87,43,19,10,5,13,22,31,12,34,88,9,28,25,60,10,15,92
New Orleans,5,"November 2, 2016",Memphis,0,0,83,89,1,53,83,43,17,8,9,21,26,38,5,30,81,11,34,19,47,12,16,84
Washington,5,"November 5, 2016",Orlando,0,0,86,88,1,48,86,49,11,4,5,10,23,35,14,34,86,6,17,28,69,12,17,88
Brooklyn,5,"November 2, 2016",Detroit,1,1,109,101,1,48,109,45,27,10,3,19,23,40,5,41,76,13,27,28,49,14,17,137
Memphis,5,"November 2, 2016",New Orleans,1,1,89,83,1,53,89,52,20,12,5,17,22,39,13,33,94,8,27,25,67,15,20,95
Utah,5,"November 2, 2016",Dallas,1,1,97,81,1,48,97,41,18,6,3,12,21,34,7,35,77,12,25,23,52,15,26,100
Toronto,5,"November 4, 2016",Miami,1,1,96,87,1,48,96,50,14,7,5,15,16,37,13,37,84,6,25,31,59,16,18,108
Golden State,5,"November 3, 2016",Oklahoma City,1,1,122,96,1,48,122,47,27,9,14,15,18,31,16,46,90,14,30,32,60,16,20,156
New York,5,"November 4, 2016",Chicago,0,1,117,104,1,48,117,40,32,7,2,5,23,29,11,46,89,9,21,37,68,16,21,145
Orlando,5,"November 3, 2016",Sacramento,1,1,102,94,1,48,102,44,24,5,4,14,14,31,13,38,84,10,30,28,54,16,23,112
Oklahoma City,5,"November 3, 2016",Golden State,0,0,96,122,1,48,96,41,20,8,7,16,20,28,13,35,87,10,27,25,60,16,28,92
Denver,5,"November 5, 2016",Detroit,0,0,86,103,1,48,86,48,15,8,1,16,15,32,16,31,94,7,25,24,69,17,20,76
Dallas,5,"November 4, 2016",Portland,1,0,95,105,1,48,95,44,18,5,3,12,21,37,7,34,83,10,28,24,55,17,20,101
Charlotte,5,"November 4, 2016",Brooklyn,0,1,99,95,1,48,99,49,24,7,3,16,18,42,7,36,86,10,30,26,56,17,24,109
L.A. Lakers,5,"November 2, 2016",Atlanta,0,1,123,116,1,48,123,41,24,11,9,15,25,31,10,48,89,9,22,39,67,18,20,150
Detroit,5,"November 2, 2016",Brooklyn,0,0,101,109,1,48,101,38,21,11,6,13,18,28,10,37,88,9,25,28,63,18,21,110
Portland,5,"November 2, 2016",Phoenix,0,0,115,118,1,53,115,53,25,8,8,14,23,43,10,42,101,12,33,30,68,19,21,134
San Antonio,5,"November 1, 2016",Utah,1,0,91,106,1,48,91,34,19,6,5,9,15,30,4,33,76,6,20,27,56,19,21,101
Boston,5,"November 3, 2016",Cleveland,0,0,122,128,1,48,122,38,25,4,7,8,28,28,10,46,95,11,32,35,63,19,22,136
Milwaukee,5,"November 3, 2016",Indiana,1,1,125,107,1,48,125,41,32,10,6,22,23,29,12,47,81,12,27,35,54,19,24,153
Houston,5,"November 2, 2016",New York,0,1,118,99,1,48,118,54,25,12,7,19,21,35,19,42,89,15,40,27,49,19,27,142
Indiana,5,"November 3, 2016",Milwaukee,0,0,107,125,1,48,107,31,29,15,3,21,23,21,10,38,81,10,23,28,58,21,27,115
Chicago,5,"November 4, 2016",New York,1,0,104,117,1,48,104,42,15,4,4,12,16,27,15,37,84,8,23,29,61,22,27,105
Minnesota,5,"November 5, 2016",Oklahoma City,0,0,92,112,1,48,92,41,12,7,8,17,19,24,17,33,84,4,19,29,65,22,29,85
Sacramento,5,"November 1, 2016",Miami,0,0,96,108,1,53,96,53,12,4,4,15,23,44,9,34,89,5,23,29,66,23,27,95
Atlanta,5,"November 4, 2016",Washington,0,0,92,95,1,48,92,47,22,12,3,18,24,37,10,32,83,5,25,27,58,23,36,94
Phoenix,5,"November 2, 2016",Portland,1,1,118,115,1,53,118,59,15,10,5,12,20,45,14,44,103,5,16,39,87,25,30,131
L.A. Clippers,5,"November 4, 2016",Memphis,0,1,99,88,1,48,99,48,19,17,6,11,23,36,12,32,85,8,27,24,58,27,33,119
Cleveland,5,"November 3, 2016",Boston,1,1,128,122,1,48,128,44,24,6,7,8,19,34,10,41,85,14,34,27,51,32,37,152
Indiana,6,"November 5, 2016",Chicago,1,1,111,94,1,48,111,36,27,8,9,11,20,28,8,46,86,12,26,34,60,7,12,135
Dallas,6,"November 6, 2016",Milwaukee,1,1,86,75,1,53,86,46,14,12,2,15,20,36,10,33,88,9,38,24,50,11,12,89
Houston,6,"November 5, 2016",Atlanta,0,0,97,112,1,48,97,43,22,8,7,25,26,31,12,37,85,12,36,25,49,11,13,102
Sacramento,6,"November 3, 2016",Orlando,0,0,94,102,1,48,94,39,17,8,1,14,23,28,11,38,80,7,18,31,62,11,17,97
L.A. Clippers,6,"November 5, 2016",San Antonio,0,1,116,92,1,48,116,41,24,8,6,8,19,34,7,47,91,9,23,38,68,13,14,142
Cleveland,6,"November 5, 2016",Philadelphia,0,1,102,101,1,48,102,49,23,10,5,16,15,38,11,37,91,14,38,23,53,14,18,115
Golden State,6,"November 4, 2016",L.A.Lakers,0,0,97,117,1,48,97,40,26,13,3,20,13,31,9,39,86,5,32,34,54,14,20,106
Atlanta,6,"November 5, 2016",Houston,1,1,112,97,1,48,112,44,29,16,5,18,13,31,13,45,85,8,20,37,65,14,24,138
Philadelphia,6,"November 7, 2016",Utah,1,0,84,109,1,48,84,42,16,5,2,18,19,33,9,31,77,7,21,24,56,15,22,78
Oklahoma City,6,"November 5, 2016",Minnesota,1,1,112,92,1,48,112,41,24,9,9,12,21,30,11,45,86,7,16,38,70,15,24,133
Utah,6,"November 4, 2016",San Antonio,1,0,86,100,1,48,86,42,15,7,4,12,19,33,9,30,80,11,26,19,54,15,24,83
New Orleans,6,"November 4, 2016",Phoenix,1,0,111,112,1,53,111,45,28,6,14,8,21,37,8,43,94,10,30,33,64,15,28,132
Brooklyn,6,"November 4, 2016",Charlotte,1,0,95,99,1,48,95,46,20,12,3,15,22,39,7,35,87,9,36,26,51,16,21,104
Detroit,6,"November 5, 2016",Denver,1,1,103,86,1,48,103,47,22,9,9,13,16,39,8,40,83,7,20,33,63,16,22,128
New York,6,"November 6, 2016",Utah,1,0,109,114,1,48,109,39,18,8,5,12,26,29,10,42,83,8,20,34,63,17,19,124
Boston,6,"November 6, 2016",Denver,1,0,107,123,1,48,107,39,31,3,5,11,24,28,11,41,90,8,25,33,65,17,21,121
Memphis,6,"November 4, 2016",L.A.Clippers,1,0,88,99,1,48,88,48,26,4,9,18,28,35,13,31,84,9,26,22,58,17,22,99
Orlando,6,"November 5, 2016",Washington,1,1,88,86,1,48,88,43,21,4,6,9,16,33,10,31,78,9,28,22,50,17,27,96
Washington,6,"November 7, 2016",Houston,1,0,106,114,1,48,106,45,20,12,5,13,16,29,16,39,94,10,27,29,67,18,20,118
L.A. Lakers,6,"November 4, 2016",Golden State,1,1,117,97,1,48,117,51,26,9,5,16,19,35,16,45,95,8,30,37,65,19,21,140
Miami,6,"November 7, 2016",Oklahoma City,0,0,85,97,1,48,85,41,12,8,7,12,16,29,12,31,84,4,17,27,67,19,22,85
San Antonio,6,"November 4, 2016",Utah,0,1,100,86,1,48,100,49,17,9,8,11,25,40,9,37,83,6,20,31,63,20,22,124
Chicago,6,"November 5, 2016",Indiana,0,0,94,111,1,48,94,40,17,8,5,16,13,27,13,34,79,6,18,28,61,20,25,98
Minnesota,6,"November 8, 2016",Brooklyn,0,0,110,119,1,48,110,41,20,11,3,16,21,26,15,39,92,12,28,27,64,20,28,108
Milwaukee,6,"November 5, 2016",Sacramento,1,1,117,91,1,48,117,53,28,12,10,15,22,36,17,41,82,14,33,27,49,21,25,160
Portland,6,"November 4, 2016",Dallas,0,1,105,95,1,48,105,42,21,9,3,14,20,35,7,36,80,12,31,24,49,21,26,117
Phoenix,6,"November 4, 2016",New Orleans,0,1,112,111,1,53,112,58,18,7,2,14,27,46,12,40,93,8,24,32,69,24,28,126
Toronto,6,"November 6, 2016",Sacramento,1,0,91,96,1,48,91,43,22,6,5,6,26,30,13,30,84,7,30,23,54,24,31,100
Denver,6,"November 6, 2016",Boston,0,1,123,107,1,48,123,47,21,7,6,17,23,38,9,44,84,11,23,33,61,24,31,140
Charlotte,6,"November 7, 2016",Indiana,1,1,122,100,1,48,122,43,30,12,3,11,15,40,3,41,84,12,32,29,52,28,32,152
Orlando,7,"November 7, 2016",Chicago,0,0,80,112,1,48,80,39,28,6,7,14,23,33,6,33,85,9,30,24,55,5,6,93
Milwaukee,7,"November 6, 2016",Dallas,0,0,75,86,1,53,75,51,14,11,2,27,26,42,9,30,82,6,29,24,53,9,12,71
Philadelphia,7,"November 9, 2016",Indiana,0,0,115,122,1,53,115,44,23,10,7,17,21,34,10,46,95,14,36,32,59,9,19,123
Golden State,7,"November 7, 2016",New Orleans,1,1,116,106,1,48,116,38,35,14,4,15,17,28,10,45,90,16,35,29,55,10,12,145
Miami,7,"November 10, 2016",Chicago,1,0,95,98,1,48,95,46,22,8,5,13,19,32,14,36,88,13,29,23,59,10,15,106
Indiana,7,"November 7, 2016",Charlotte,0,0,100,122,1,48,100,51,23,8,4,18,25,40,11,40,93,9,33,31,60,11,15,111
New York,7,"November 9, 2016",Brooklyn,1,1,110,96,1,48,110,50,25,11,5,14,21,41,9,44,92,10,30,34,62,12,17,134
Dallas,7,"November 8, 2016",L.A.Lakers,0,1,109,97,1,48,109,37,24,11,4,11,12,29,8,43,82,10,23,33,59,13,15,133
Boston,7,"November 9, 2016",Washington,0,0,93,118,1,48,93,31,21,5,4,11,19,24,7,35,81,10,31,25,50,13,22,88
Oklahoma City,7,"November 7, 2016",Miami,1,1,97,85,1,48,97,47,24,8,5,16,18,37,10,37,85,9,28,28,57,14,17,114
Houston,7,"November 7, 2016",Washington,0,1,114,106,1,48,114,37,28,6,7,18,18,31,6,41,79,17,37,24,42,15,18,133
Sacramento,7,"November 5, 2016",Milwaukee,0,0,91,117,1,48,91,36,27,8,3,14,19,23,13,33,84,10,28,23,56,15,19,96
Toronto,7,"November 9, 2016",Oklahoma City,0,1,112,102,1,48,112,35,25,10,6,11,24,28,7,43,83,11,26,32,57,15,22,130
Washington,7,"November 9, 2016",Boston,1,1,118,93,1,48,118,54,29,10,7,11,26,35,19,46,92,10,21,36,71,16,20,157
Atlanta,7,"November 8, 2016",Cleveland,0,1,110,106,1,48,110,50,22,1,4,19,21,39,11,41,81,11,29,30,52,17,24,121
Detroit,7,"November 7, 2016",L.A.Clippers,0,0,82,114,1,48,82,39,14,5,2,11,19,28,11,30,82,4,12,26,70,18,26,71
L.A. Clippers,7,"November 7, 2016",Detroit,1,1,114,82,1,48,114,46,28,8,7,10,20,44,2,41,76,13,25,28,51,19,22,155
Minnesota,7,"November 9, 2016",Orlando,0,1,123,107,1,48,123,45,27,8,5,6,23,35,10,45,87,13,23,32,64,20,26,154
Charlotte,7,"November 9, 2016",Utah,1,1,104,98,1,48,104,37,24,8,4,8,19,32,5,38,82,8,26,30,56,20,29,116
Cleveland,7,"November 8, 2016",Atlanta,1,0,106,110,1,48,106,39,21,12,1,6,20,26,13,37,99,11,42,26,57,21,25,107
New Orleans,7,"November 7, 2016",Golden State,0,0,106,116,1,48,106,43,26,8,1,19,16,32,11,39,80,7,21,32,59,21,27,118
San Antonio,7,"November 5, 2016",L.A.Clippers,1,0,92,116,1,48,92,40,19,5,5,15,18,33,7,30,74,10,25,20,49,22,25,99
Portland,7,"November 6, 2016",Memphis,0,1,100,94,1,48,100,37,19,7,5,15,25,32,5,32,71,14,33,18,38,22,27,109
Phoenix,7,"November 6, 2016",L.A.Lakers,0,0,108,119,1,48,108,40,20,8,2,17,30,29,11,40,91,6,20,34,71,22,28,104
Brooklyn,7,"November 8, 2016",Minnesota,1,1,119,110,1,48,119,43,20,5,5,20,19,38,5,42,76,12,33,30,43,23,26,135
Chicago,7,"November 7, 2016",Orlando,1,1,112,80,1,48,112,56,26,7,4,8,11,41,15,42,89,3,19,39,70,25,31,144
Memphis,7,"November 6, 2016",Portland,1,0,94,100,1,48,94,44,15,9,5,13,20,32,12,31,81,6,26,25,55,26,32,98
Denver,7,"November 8, 2016",Memphis,0,0,107,108,1,48,107,39,24,6,4,22,23,33,6,35,70,10,24,25,46,27,34,116
L.A. Lakers,7,"November 6, 2016",Phoenix,1,1,119,108,1,48,119,53,22,8,5,19,22,38,15,41,90,10,23,31,67,27,35,131
Utah,7,"November 6, 2016",New York,0,1,114,109,1,48,114,34,21,6,4,10,19,27,7,38,75,8,25,30,50,30,35,127
Miami,8,"November 12, 2016",Utah,1,0,91,102,1,48,91,39,21,5,4,8,17,35,4,38,81,5,17,33,64,10,19,100
L.A. Lakers,8,"November 8, 2016",Dallas,1,0,97,109,1,48,97,37,20,6,1,16,19,29,8,38,78,10,26,28,52,11,14,102
Denver,8,"November 10, 2016",Golden State,1,0,101,125,1,48,101,44,26,7,3,18,18,27,17,38,94,13,36,25,58,12,17,102
Utah,8,"November 7, 2016",Philadelphia,0,1,109,84,1,48,109,45,20,10,11,10,22,35,10,43,85,11,19,32,66,12,20,135
New Orleans,8,"November 8, 2016",Sacramento,0,0,94,102,1,48,94,40,23,5,9,10,23,33,7,38,84,5,21,33,63,13,18,110
Memphis,8,"November 8, 2016",Denver,1,1,108,107,1,48,108,32,29,14,5,14,30,24,8,44,86,7,24,37,62,13,19,126
Golden State,8,"November 9, 2016",Dallas,1,1,116,95,1,48,116,39,33,3,6,15,22,34,5,43,74,17,33,26,41,13,22,142
New York,8,"November 11, 2016",Boston,0,0,87,115,1,48,87,57,19,7,11,25,26,36,21,33,94,6,23,27,71,15,17,93
Washington,8,"November 11, 2016",Cleveland,1,0,94,105,1,48,94,46,16,7,5,15,21,36,10,38,87,3,15,35,72,15,19,100
Indiana,8,"November 9, 2016",Philadelphia,1,1,122,115,1,53,122,43,25,9,7,15,17,36,7,49,91,9,19,40,72,15,20,144
Chicago,8,"November 9, 2016",Atlanta,0,0,107,115,1,48,107,30,24,15,3,13,21,23,7,41,91,9,27,32,64,16,21,111
Minnesota,8,"November 12, 2016",L.A.Clippers,1,0,105,119,1,48,105,39,26,11,3,13,31,24,15,40,89,8,22,32,67,17,21,118
Houston,8,"November 9, 2016",San Antonio,0,1,101,99,1,48,101,45,25,7,4,19,24,37,8,37,78,10,30,27,48,17,22,117
Charlotte,8,"November 11, 2016",Toronto,1,0,111,113,1,48,111,57,22,1,4,11,16,39,18,38,93,17,41,21,52,18,24,123
Cleveland,8,"November 11, 2016",Washington,0,1,105,94,1,48,105,47,16,9,6,15,21,34,13,36,86,14,33,22,53,19,26,111
Brooklyn,8,"November 9, 2016",New York,0,0,96,110,1,48,96,41,19,9,4,18,20,33,8,33,80,11,33,22,47,19,27,96
Milwaukee,8,"November 10, 2016",New Orleans,1,0,106,112,1,48,106,48,23,4,5,11,20,37,11,40,91,6,18,34,73,20,25,119
Portland,8,"November 8, 2016",Phoenix,1,1,124,121,1,48,124,35,22,5,4,20,27,28,7,45,81,14,31,31,50,20,28,126
Toronto,8,"November 11, 2016",Charlotte,0,1,113,111,1,48,113,45,18,8,5,5,21,37,8,43,90,6,22,37,68,21,22,136
Dallas,8,"November 9, 2016",Golden State,0,0,95,116,1,48,95,42,20,10,2,7,20,29,13,34,86,6,28,28,58,21,28,103
Atlanta,8,"November 9, 2016",Chicago,1,1,115,107,1,48,115,49,24,8,7,22,20,36,13,42,83,9,20,33,63,22,27,135
Orlando,8,"November 9, 2016",Minnesota,1,0,107,123,1,48,107,40,20,2,5,9,19,28,12,38,85,8,24,30,61,23,30,111
Sacramento,8,"November 6, 2016",Toronto,0,1,96,91,1,48,96,47,21,4,5,9,22,34,13,34,78,5,16,29,62,23,31,112
L.A. Clippers,8,"November 9, 2016",Portland,1,1,111,80,1,48,111,55,24,9,7,7,15,41,14,38,87,11,32,27,55,24,33,141
San Antonio,8,"November 9, 2016",Houston,1,0,99,101,1,48,99,39,22,14,5,10,15,29,10,33,84,7,23,26,61,26,30,114
Philadelphia,8,"November 11, 2016",Indiana,1,1,109,105,1,53,109,54,24,7,6,19,21,41,13,36,86,11,32,25,54,26,31,126
Detroit,8,"November 9, 2016",Phoenix,0,0,100,107,1,48,100,41,20,11,5,11,24,32,9,32,89,9,22,23,67,27,32,104
Oklahoma City,8,"November 9, 2016",Toronto,1,0,102,112,1,48,102,39,18,6,5,19,21,28,11,31,74,12,34,19,40,28,31,105
Phoenix,8,"November 8, 2016",Portland,0,0,121,124,1,48,121,41,18,10,2,16,27,26,15,43,86,7,21,36,65,28,33,128
Boston,8,"November 11, 2016",New York,1,1,115,87,1,48,115,53,23,16,3,15,18,34,19,35,90,11,27,24,63,34,43,131
Dallas,9,"November 14, 2016",New York,0,0,77,93,1,48,77,42,15,8,7,12,16,29,13,32,83,5,28,27,55,8,11,83
Atlanta,9,"November 12, 2016",Philadelphia,1,1,117,96,1,48,117,52,31,10,6,16,14,37,15,48,95,13,32,35,63,8,14,147
Cleveland,9,"November 13, 2016",Charlotte,1,1,100,93,1,48,100,53,25,3,9,9,13,41,12,39,92,14,38,25,54,8,15,121
Charlotte,9,"November 13, 2016",Cleveland,0,0,93,100,1,48,93,45,23,7,3,5,19,35,10,36,95,11,29,25,66,10,12,105
Portland,9,"November 9, 2016",L.A.Clippers,0,0,80,111,1,48,80,47,16,4,3,14,23,36,11,31,88,6,30,25,58,12,14,77
New York,9,"November 12, 2016",Toronto,0,0,107,118,1,48,107,49,19,3,2,16,23,32,17,44,97,7,23,37,74,12,16,107
Miami,9,"November 14, 2016",San Antonio,0,0,90,94,1,48,90,42,22,14,8,13,23,31,11,37,85,4,16,33,69,12,21,106
Philadelphia,9,"November 12, 2016",Atlanta,0,0,96,117,1,48,96,39,21,14,4,19,20,29,10,36,83,11,29,25,54,13,20,101
Utah,9,"November 9, 2016",Charlotte,0,0,98,104,1,48,98,46,24,5,6,12,22,36,10,38,82,8,34,30,48,14,18,119
Orlando,9,"November 11, 2016",Utah,1,0,74,87,1,48,74,43,13,11,6,12,18,35,8,26,78,8,20,18,58,14,19,78
Denver,9,"November 12, 2016",Detroit,1,0,95,106,1,48,95,42,15,6,4,15,14,28,14,36,84,9,25,27,59,14,19,94
Washington,9,"November 12, 2016",Chicago,0,0,95,106,1,48,95,49,19,3,7,12,22,36,13,38,91,4,13,34,78,15,18,105
San Antonio,9,"November 11, 2016",Detroit,1,1,96,86,1,48,96,45,24,8,2,8,13,35,10,36,81,9,20,27,61,15,19,118
Oklahoma City,9,"November 11, 2016",L.A.Clippers,1,0,108,110,1,48,108,45,21,3,1,16,27,36,9,38,88,16,28,22,60,16,19,109
Sacramento,9,"November 8, 2016",New Orleans,1,1,102,94,1,48,102,39,24,7,6,10,21,34,5,39,81,8,25,31,56,16,20,122
L.A. Lakers,9,"November 10, 2016",Sacramento,0,1,101,91,1,48,101,42,18,8,2,21,19,38,4,38,74,9,27,29,47,16,22,108
Detroit,9,"November 11, 2016",San Antonio,0,0,86,96,1,48,86,42,14,2,4,11,14,33,9,32,76,5,25,27,51,17,21,89
Houston,9,"November 12, 2016",San Antonio,1,0,100,106,1,48,100,46,22,6,4,14,19,30,16,34,89,15,47,19,42,17,21,105
Chicago,9,"November 10, 2016",Miami,0,1,98,95,1,48,98,48,18,7,2,10,12,36,12,37,89,6,16,31,73,18,20,109
Golden State,9,"November 10, 2016",Denver,0,1,125,101,1,48,125,44,33,15,6,15,18,35,9,46,85,14,30,32,55,19,20,168
Memphis,9,"November 12, 2016",Milwaukee,0,0,96,106,1,48,96,32,20,8,4,13,26,29,3,35,78,6,30,29,48,20,21,103
L.A. Clippers,9,"November 11, 2016",Oklahoma City,0,1,110,108,1,48,110,45,18,9,3,10,20,34,11,39,86,11,27,28,59,21,35,114
Indiana,9,"November 11, 2016",Philadelphia,0,0,105,109,1,53,105,40,23,14,2,13,28,36,4,39,88,5,19,34,69,22,23,121
Phoenix,9,"November 9, 2016",Detroit,1,1,107,100,1,48,107,49,20,7,6,17,20,39,10,38,84,8,22,30,62,23,30,119
New Orleans,9,"November 10, 2016",Milwaukee,0,1,112,106,1,48,112,47,22,9,7,10,19,36,11,39,89,9,25,30,64,25,27,135
Brooklyn,9,"November 12, 2016",Phoenix,0,1,122,104,1,48,122,55,22,6,10,17,19,49,6,40,84,16,37,24,47,26,30,150
Boston,9,"November 12, 2016",Indiana,0,1,105,99,1,48,105,47,22,7,7,13,21,32,15,35,80,8,25,27,55,27,33,124
Milwaukee,9,"November 12, 2016",Memphis,1,1,106,96,1,48,106,35,20,9,5,12,20,30,5,36,68,7,18,29,50,27,36,122
Minnesota,9,"November 13, 2016",L.A.Lakers,1,1,125,99,1,48,125,44,28,10,4,10,19,35,9,42,80,13,27,29,53,28,42,149
Toronto,9,"November 12, 2016",New York,1,1,118,107,1,48,118,44,18,10,6,11,20,33,11,39,83,7,22,32,61,33,38,136
L.A. Lakers,10,"November 12, 2016",New Orleans,0,1,126,99,1,48,126,47,36,8,5,10,17,37,10,52,94,16,30,36,64,6,7,169
Dallas,10,"November 16, 2016",Boston,0,0,83,90,1,48,83,32,16,9,3,9,19,27,5,34,83,8,23,26,60,7,10,82
Detroit,10,"November 12, 2016",Denver,0,1,106,95,1,48,106,37,23,11,1,9,16,26,11,46,90,4,18,42,72,10,14,121
Houston,10,"November 14, 2016",Philadelphia,1,1,115,88,1,48,115,56,20,6,10,18,19,39,17,44,91,17,40,27,51,10,17,135
Miami,10,"November 15, 2016",Atlanta,1,0,90,93,1,48,90,48,13,11,7,23,23,31,17,36,89,7,23,29,66,11,14,90
Toronto,10,"November 15, 2016",Cleveland,0,0,117,121,1,48,117,40,24,11,5,8,25,28,12,46,96,13,29,33,67,12,18,133
Atlanta,10,"November 15, 2016",Miami,0,1,93,90,1,48,93,35,18,14,4,19,13,29,6,37,80,6,17,31,63,13,19,96
Utah,10,"November 11, 2016",Orlando,0,1,87,74,1,48,87,52,19,9,7,15,18,40,12,33,81,7,28,26,53,14,16,109
Milwaukee,10,"November 16, 2016",Atlanta,0,0,100,107,1,48,100,47,25,9,3,14,25,32,15,39,98,8,32,31,66,14,18,107
Philadelphia,10,"November 14, 2016",Houston,0,0,88,115,1,48,88,38,18,11,7,12,17,28,10,34,90,5,22,29,68,15,17,92
New Orleans,10,"November 12, 2016",L.A.Lakers,1,0,99,126,1,48,99,42,20,4,5,10,10,30,12,39,90,6,20,33,70,15,19,105
Sacramento,10,"November 10, 2016",L.A.Lakers,1,0,91,101,1,48,91,43,18,13,3,15,19,32,11,34,85,8,21,26,64,15,20,97
New York,10,"November 14, 2016",Dallas,1,1,93,77,1,48,93,51,18,6,4,17,16,37,14,34,78,9,25,25,53,16,18,109
Orlando,10,"November 13, 2016",Oklahoma City,0,1,119,117,1,48,119,38,24,4,7,9,20,30,8,46,86,11,24,35,62,16,20,139
Phoenix,10,"November 12, 2016",Brooklyn,1,0,104,122,1,48,104,55,23,9,3,12,20,38,17,40,107,8,33,32,74,16,21,110
Oklahoma City,10,"November 13, 2016",Orlando,1,0,117,119,1,48,117,42,22,4,6,10,19,30,12,47,92,7,25,40,67,16,26,126
Boston,10,"November 14, 2016",New Orleans,0,0,105,106,1,48,105,44,19,9,0,10,27,33,11,38,95,12,41,26,54,17,20,107
Minnesota,10,"November 15, 2016",Charlotte,1,0,108,115,1,48,108,43,25,4,5,18,19,29,14,38,89,15,35,23,54,17,21,112
Brooklyn,10,"November 14, 2016",L.A.Clippers,0,0,95,127,1,48,95,37,18,6,2,21,21,28,9,34,77,10,33,24,44,17,22,89
Charlotte,10,"November 15, 2016",Minnesota,0,1,115,108,1,48,115,37,25,10,6,13,17,33,4,43,80,11,24,32,56,18,22,139
Washington,10,"November 16, 2016",Philadelphia,0,0,102,109,1,48,102,40,18,8,1,11,26,29,11,38,91,8,23,30,68,18,25,98
San Antonio,10,"November 12, 2016",Houston,0,1,106,100,1,48,106,35,21,6,11,10,19,33,2,41,76,5,18,36,58,19,24,129
Portland,10,"November 11, 2016",Sacramento,1,1,122,120,1,53,122,36,29,8,5,11,24,29,7,45,86,13,33,32,53,19,27,140
Cleveland,10,"November 15, 2016",Toronto,1,1,121,117,1,48,121,46,26,4,7,17,18,36,10,44,83,13,33,31,50,20,28,140
Indiana,10,"November 12, 2016",Boston,1,0,99,105,1,48,99,40,17,9,9,13,22,29,11,36,86,6,27,30,59,21,28,104
Memphis,10,"November 14, 2016",Utah,0,1,102,96,1,48,102,44,13,4,2,16,26,30,14,36,76,8,21,28,55,22,26,105
Denver,10,"November 13, 2016",Portland,0,0,105,112,1,48,105,59,11,4,6,18,25,43,16,36,91,11,29,25,62,22,29,105
Chicago,10,"November 12, 2016",Washington,1,1,106,95,1,48,106,52,21,7,6,10,20,37,15,39,97,5,15,34,82,23,25,122
Golden State,10,"November 13, 2016",Phoenix,1,1,133,120,1,48,133,43,32,8,7,16,20,35,8,45,87,16,33,29,54,27,31,161
L.A. Clippers,10,"November 12, 2016",Minnesota,0,1,119,105,1,48,119,42,25,7,4,14,19,33,9,40,76,11,24,29,52,28,37,138
Houston,11,"November 16, 2016",Oklahoma City,0,0,103,105,1,48,103,47,25,10,4,16,10,35,12,40,92,14,40,26,52,9,14,116
Indiana,11,"November 14, 2016",Orlando,1,1,88,69,1,48,88,49,22,9,9,9,14,42,7,35,90,8,25,27,65,10,10,113
Orlando,11,"November 14, 2016",Indiana,0,0,69,88,1,48,69,52,12,3,5,14,17,43,9,27,84,5,25,22,59,10,13,67
Milwaukee,11,"November 17, 2016",Miami,0,0,73,96,1,48,73,48,20,4,8,13,20,36,12,28,85,7,23,21,62,10,13,80
Miami,11,"November 17, 2016",Milwaukee,1,1,96,73,1,48,96,59,19,5,8,7,18,42,17,39,97,7,30,32,67,11,21,112
New York,11,"November 16, 2016",Detroit,1,1,105,102,1,48,105,52,24,8,9,9,11,33,19,42,93,9,25,33,68,12,19,131
Cleveland,11,"November 16, 2016",Indiana,0,0,93,103,1,48,93,51,19,3,5,18,16,40,11,35,86,11,30,24,56,12,20,94
Detroit,11,"November 14, 2016",Oklahoma City,1,1,104,88,1,48,104,47,25,4,9,9,14,43,4,43,92,5,16,38,76,13,16,128
Philadelphia,11,"November 16, 2016",Washington,1,1,109,102,1,48,109,41,30,6,1,17,26,36,5,42,77,10,28,32,49,15,22,128
Washington,11,"November 17, 2016",New York,1,1,119,112,1,48,119,37,26,7,2,15,21,30,7,44,81,15,25,29,56,16,18,137
Utah,11,"November 12, 2016",Miami,0,1,102,91,1,48,102,45,12,5,4,9,19,39,6,40,81,6,20,34,61,16,19,115
Memphis,11,"November 16, 2016",L.A.Clippers,0,1,111,107,1,48,111,43,24,6,2,15,22,34,9,40,82,15,26,25,56,16,19,126
Brooklyn,11,"November 15, 2016",L.A.Lakers,0,0,118,125,1,48,118,47,23,8,6,14,27,38,9,45,99,12,41,33,58,16,20,130
Charlotte,11,"November 18, 2016",Atlanta,1,1,100,96,1,48,100,44,25,11,4,11,16,36,8,37,90,10,29,27,61,16,24,112
L.A. Clippers,11,"November 14, 2016",Brooklyn,1,1,127,95,1,48,127,43,32,17,6,11,22,34,9,48,90,14,25,34,65,17,21,168
Dallas,11,"November 18, 2016",Memphis,1,0,64,80,1,48,64,45,9,3,8,17,14,35,10,21,73,5,25,16,48,17,22,55
Oklahoma City,11,"November 14, 2016",Detroit,0,0,88,104,1,48,88,51,16,3,6,15,21,38,13,33,88,5,27,28,61,17,22,89
Boston,11,"November 16, 2016",Dallas,1,1,90,83,1,48,90,53,18,6,3,19,17,40,13,33,76,7,21,26,55,17,23,102
Minnesota,11,"November 17, 2016",Philadelphia,1,1,110,86,1,48,110,49,18,7,8,13,19,34,15,43,85,6,26,37,59,18,20,135
Phoenix,11,"November 13, 2016",Golden State,0,0,120,133,1,48,120,38,27,10,3,13,29,30,8,46,90,8,24,38,66,20,26,135
San Antonio,11,"November 14, 2016",Miami,1,1,94,90,1,48,94,53,24,4,7,17,15,38,15,33,82,8,15,25,67,20,27,109
Denver,11,"November 16, 2016",Phoenix,1,1,120,104,1,48,120,49,23,8,4,14,24,35,14,45,93,8,17,37,76,22,24,140
Chicago,11,"November 15, 2016",Portland,0,1,113,88,1,48,113,67,16,7,4,10,19,48,19,41,98,7,20,34,78,24,28,136
L.A. Lakers,11,"November 13, 2016",Minnesota,0,0,99,125,1,48,99,39,16,6,5,17,31,34,5,33,71,8,24,25,47,25,30,105
Golden State,11,"November 16, 2016",Toronto,0,1,127,121,1,48,127,35,33,9,7,12,25,28,7,44,87,13,36,31,51,26,28,154
Portland,11,"November 13, 2016",Denver,1,1,112,105,1,48,112,44,21,8,8,7,23,30,14,39,99,8,29,31,70,26,32,120
Atlanta,11,"November 16, 2016",Milwaukee,1,1,107,100,1,48,107,39,29,6,8,16,17,36,3,35,72,10,32,25,40,27,31,132
Sacramento,11,"November 11, 2016",Portland,0,0,120,122,1,53,120,48,18,7,3,15,21,35,13,43,88,6,21,37,67,28,35,129
New Orleans,11,"November 14, 2016",Boston,1,1,106,105,1,48,106,46,16,9,4,16,17,38,8,35,79,6,21,29,58,30,36,115
Toronto,11,"November 16, 2016",Golden State,1,0,121,127,1,48,121,46,16,8,1,14,22,33,13,37,82,10,25,27,57,37,41,129
Indiana,12,"November 16, 2016",Cleveland,1,1,103,93,1,48,103,40,22,8,12,10,16,35,5,43,86,10,28,33,58,7,11,128
Golden State,12,"November 18, 2016",Boston,0,1,104,88,1,48,104,50,33,10,7,11,20,41,9,44,90,9,28,35,62,7,12,142
Memphis,12,"November 18, 2016",Dallas,0,1,80,64,1,48,80,48,16,7,3,12,25,41,7,31,77,9,25,22,52,9,12,93
Detroit,12,"November 16, 2016",New York,0,0,102,105,1,48,102,40,19,6,1,10,14,32,8,42,85,8,23,34,62,10,12,113
Atlanta,12,"November 18, 2016",Charlotte,0,0,96,100,1,48,96,49,25,9,6,16,18,41,8,39,84,7,28,32,56,11,17,118
Portland,12,"November 15, 2016",Chicago,1,0,88,113,1,48,88,49,17,8,4,11,18,34,15,34,95,9,34,25,61,11,18,87
Orlando,12,"November 16, 2016",New Orleans,1,1,89,82,1,48,89,50,17,7,7,12,15,37,13,34,88,10,27,24,61,11,19,96
Cleveland,12,"November 18, 2016",Detroit,1,1,104,81,1,48,104,52,26,4,8,13,14,47,5,40,83,11,25,29,58,13,14,137
Oklahoma City,12,"November 16, 2016",Houston,1,1,105,103,1,48,105,44,25,7,7,16,15,39,5,40,84,12,25,28,59,13,14,127
San Antonio,12,"November 16, 2016",Sacramento,0,1,110,105,1,48,110,37,29,11,7,11,21,28,9,43,88,11,30,32,58,13,17,134
Chicago,12,"November 17, 2016",Utah,0,1,85,77,1,48,85,46,8,7,6,8,16,32,14,33,90,5,17,28,73,14,16,85
Minnesota,12,"November 19, 2016",Memphis,0,0,71,93,1,48,71,34,16,5,5,16,25,29,5,25,64,7,22,18,42,14,22,68
Philadelphia,12,"November 17, 2016",Minnesota,0,0,86,110,1,48,86,40,15,9,2,15,17,27,13,31,83,9,32,22,51,15,19,81
Boston,12,"November 18, 2016",Golden State,1,0,88,104,1,48,88,43,19,6,3,13,12,36,7,31,83,11,32,20,51,15,19,90
New Orleans,12,"November 16, 2016",Orlando,0,0,82,89,1,48,82,48,19,5,9,17,16,39,9,30,82,7,21,23,61,15,19,90
Miami,12,"November 19, 2016",Washington,0,1,114,111,1,48,114,48,21,5,7,16,21,30,18,43,85,13,27,30,58,15,26,126
Washington,12,"November 19, 2016",Miami,1,0,111,114,1,48,111,38,22,9,5,10,22,26,12,42,88,11,27,31,61,16,22,123
New York,12,"November 17, 2016",Washington,0,0,112,119,1,48,112,36,23,9,1,13,20,26,10,41,86,12,29,29,57,18,20,121
Utah,12,"November 14, 2016",Memphis,1,0,96,102,1,48,96,29,17,8,1,8,27,23,6,35,73,8,28,27,45,18,22,101
Phoenix,12,"November 16, 2016",Denver,0,0,104,120,1,48,104,35,14,8,4,16,29,28,7,39,79,8,20,31,59,18,29,98
Milwaukee,12,"November 19, 2016",Golden State,1,0,121,124,1,48,121,41,27,7,1,13,23,31,10,46,89,10,20,36,69,19,25,135
Toronto,12,"November 18, 2016",Denver,0,1,113,111,1,53,113,45,23,8,2,12,25,38,7,43,94,8,23,35,71,19,31,116
Houston,12,"November 17, 2016",Portland,1,1,126,109,1,48,126,54,26,6,6,13,17,37,17,46,95,14,32,32,63,20,25,151
Charlotte,12,"November 19, 2016",New Orleans,0,0,116,121,1,53,116,52,29,7,5,14,21,44,8,40,97,15,43,25,54,21,28,131
Dallas,12,"November 19, 2016",Orlando,0,0,87,95,1,48,87,34,13,8,5,13,16,29,5,26,77,13,28,13,49,22,27,78
Brooklyn,12,"November 18, 2016",Oklahoma City,0,0,105,124,1,48,105,30,19,6,2,16,19,23,7,35,83,11,29,24,54,24,30,92
Sacramento,12,"November 16, 2016",San Antonio,1,0,105,110,1,48,105,46,21,5,3,16,17,36,10,36,76,9,20,27,56,24,31,117
L.A. Clippers,12,"November 16, 2016",Memphis,1,0,107,111,1,48,107,35,15,13,7,8,19,27,8,37,81,9,25,28,56,24,34,115
Denver,12,"November 18, 2016",Toronto,1,0,111,113,1,53,111,58,29,8,3,19,26,49,9,39,83,4,25,35,58,29,39,136
L.A. Lakers,12,"November 15, 2016",Brooklyn,1,1,125,118,1,48,125,55,24,9,2,11,17,41,14,41,92,9,28,32,64,34,43,144
New York,13,"November 20, 2016",Atlanta,1,1,104,94,1,48,104,50,21,8,1,15,23,39,11,42,88,10,26,32,62,10,14,119
Utah,13,"November 17, 2016",Chicago,1,0,77,85,1,48,77,48,11,4,3,13,14,38,10,30,78,5,25,25,53,12,14,80
Dallas,13,"November 21, 2016",San Antonio,0,0,91,96,1,48,91,40,16,10,3,17,23,30,10,35,74,8,27,27,47,13,20,97
Philadelphia,13,"November 19, 2016",Phoenix,1,1,120,105,1,48,120,44,33,11,9,18,23,38,6,45,86,17,35,28,51,13,20,151
Denver,13,"November 20, 2016",Utah,1,1,105,91,1,48,105,49,31,4,2,8,19,37,12,42,86,8,22,34,64,13,30,122
New Orleans,13,"November 18, 2016",Portland,1,1,113,101,1,48,113,37,31,9,12,8,21,36,1,45,82,9,24,36,58,14,20,151
Phoenix,13,"November 18, 2016",Indiana,0,1,116,96,1,48,116,46,21,14,7,11,28,28,18,46,97,9,26,37,71,15,18,139
Houston,13,"November 19, 2016",Utah,1,1,111,102,1,48,111,39,28,8,3,4,16,29,10,42,94,12,32,30,62,15,20,128
Milwaukee,13,"November 21, 2016",Orlando,1,1,93,89,1,48,93,37,25,16,9,13,22,30,7,35,86,8,29,27,57,15,21,110
Boston,13,"November 19, 2016",Detroit,0,1,94,92,1,48,94,46,22,3,7,8,13,37,9,33,82,12,31,21,51,16,17,114
Detroit,13,"November 18, 2016",Cleveland,0,0,81,104,1,48,81,44,23,5,4,7,15,33,11,29,93,6,19,23,74,17,20,83
Portland,13,"November 17, 2016",Houston,0,0,109,126,1,48,109,41,24,6,4,12,19,31,10,41,90,10,28,31,62,17,21,119
L.A. Lakers,13,"November 18, 2016",San Antonio,1,0,107,116,1,48,107,45,24,6,1,13,21,30,15,39,87,12,25,27,62,17,21,118
Minnesota,13,"November 21, 2016",Boston,1,0,93,99,1,48,93,51,23,5,4,15,19,35,16,36,86,4,24,32,62,17,25,103
San Antonio,13,"November 18, 2016",L.A.Lakers,0,1,116,107,1,48,116,34,30,8,6,12,18,31,3,44,78,10,24,34,54,18,19,147
Orlando,13,"November 19, 2016",Dallas,1,1,95,87,1,48,95,50,17,6,8,19,21,40,10,34,78,8,21,26,57,19,22,110
Oklahoma City,13,"November 18, 2016",Brooklyn,1,1,124,105,1,48,124,46,23,9,5,16,24,36,10,49,89,7,26,42,63,19,24,146
Miami,13,"November 21, 2016",Philadelphia,0,0,94,101,1,48,94,50,17,7,6,13,22,29,21,34,88,7,31,27,57,19,28,98
Chicago,13,"November 19, 2016",L.A.Clippers,0,0,95,102,1,48,95,40,17,8,4,10,20,25,15,33,77,9,30,24,47,20,24,106
Cleveland,13,"November 23, 2016",Portland,1,1,137,125,1,48,137,41,30,6,4,10,15,32,9,48,90,21,36,27,54,20,27,159
Atlanta,13,"November 20, 2016",New York,0,0,94,104,1,48,94,48,17,7,5,13,15,34,14,34,85,6,21,28,64,20,29,98
Charlotte,13,"November 21, 2016",Memphis,1,0,90,105,1,48,90,39,20,6,9,10,13,31,8,30,73,9,31,21,42,21,33,99
Toronto,13,"November 20, 2016",Sacramento,0,0,99,102,1,48,99,48,16,7,6,15,21,32,16,34,85,9,24,25,61,22,24,108
Washington,13,"November 21, 2016",Phoenix,1,1,106,101,1,48,106,45,25,8,4,11,19,31,14,37,91,10,28,27,63,22,34,111
Indiana,13,"November 18, 2016",Phoenix,1,0,96,116,1,48,96,35,18,5,8,18,19,25,10,36,76,1,7,35,69,23,29,98
Brooklyn,13,"November 20, 2016",Portland,1,0,109,129,1,48,109,36,22,5,3,9,20,25,11,37,93,10,35,27,58,25,31,104
Golden State,13,"November 19, 2016",Milwaukee,0,1,124,121,1,48,124,45,30,8,5,12,25,27,18,42,95,14,38,28,57,26,32,141
L.A. Clippers,13,"November 18, 2016",Sacramento,0,1,121,115,1,48,121,37,27,7,6,14,24,32,5,40,76,13,29,27,47,28,34,142
Sacramento,13,"November 18, 2016",L.A.Clippers,1,0,115,121,1,48,115,37,21,7,4,14,24,28,9,38,86,10,26,28,60,29,35,116
Memphis,13,"November 19, 2016",Minnesota,1,1,93,71,1,48,93,46,15,8,7,9,19,33,13,29,76,2,18,27,58,33,38,108
Atlanta,14,"November 22, 2016",New Orleans,1,0,94,112,1,48,94,40,22,5,6,15,15,34,6,39,85,10,29,29,56,6,10,102
Milwaukee,14,"November 25, 2016",Toronto,1,0,99,105,1,48,99,38,26,4,2,11,19,31,7,40,79,12,29,28,50,7,12,114
New York,14,"November 22, 2016",Portland,1,1,107,103,1,48,107,43,26,8,5,13,23,33,10,45,96,9,29,36,67,8,8,125
Washington,14,"November 25, 2016",Orlando,0,1,94,91,1,48,94,37,26,10,4,11,17,30,7,40,88,6,29,34,59,8,10,110
Boston,14,"November 21, 2016",Minnesota,0,1,99,93,1,48,99,39,20,5,4,11,21,33,6,38,84,12,38,26,46,11,14,107
Detroit,14,"November 19, 2016",Boston,1,0,92,94,1,48,92,50,22,5,4,5,13,39,11,37,86,7,20,30,66,11,16,114
Utah,14,"November 19, 2016",Houston,0,0,102,111,1,48,102,43,22,3,5,12,17,38,5,39,76,12,27,27,49,12,17,121
Memphis,14,"November 21, 2016",Charlotte,0,1,105,90,1,48,105,40,24,7,8,10,24,34,6,40,84,12,26,28,58,13,17,126
Oklahoma City,14,"November 20, 2016",Indiana,1,0,111,115,1,53,111,49,28,10,7,20,23,34,15,44,101,10,36,34,65,13,18,123
Charlotte,14,"November 23, 2016",San Antonio,1,0,114,119,1,48,114,44,30,3,3,15,16,32,12,45,89,11,20,34,69,13,18,130
Denver,14,"November 22, 2016",Chicago,1,1,110,107,1,48,110,55,26,5,6,10,14,38,17,43,100,10,22,33,78,14,17,132
Brooklyn,14,"November 23, 2016",Boston,1,0,92,111,1,48,92,45,18,7,7,19,12,36,9,34,86,10,31,24,55,14,22,90
L.A. Lakers,14,"November 20, 2016",Chicago,1,0,110,118,1,48,110,37,26,11,3,10,19,27,10,41,93,13,31,28,62,15,21,119
Philadelphia,14,"November 21, 2016",Miami,1,1,101,94,1,48,101,40,21,8,5,14,25,33,7,37,78,11,26,26,52,16,20,116
Dallas,14,"November 23, 2016",L.A.Clippers,1,0,104,124,1,48,104,44,23,7,3,16,24,34,10,38,84,11,24,27,60,17,18,118
Orlando,14,"November 21, 2016",Milwaukee,0,0,89,93,1,48,89,54,21,8,5,24,18,44,10,32,77,7,25,25,52,18,24,102
San Antonio,14,"November 21, 2016",Dallas,1,1,96,91,1,48,96,39,24,9,1,13,18,31,8,35,75,8,20,27,55,18,25,109
L.A. Clippers,14,"November 19, 2016",Chicago,1,1,102,95,1,48,102,39,20,6,2,14,20,27,12,36,77,11,27,25,50,19,23,110
Sacramento,14,"November 20, 2016",Toronto,1,1,102,99,1,48,102,37,26,8,8,13,18,33,4,36,81,11,27,25,54,19,25,117
Houston,14,"November 21, 2016",Detroit,0,1,99,96,1,48,99,46,22,4,6,15,20,34,12,35,78,10,31,25,47,19,27,111
Chicago,14,"November 20, 2016",L.A.Lakers,0,1,118,110,1,48,118,56,27,6,3,16,16,40,16,45,87,8,22,37,65,20,28,144
New Orleans,14,"November 19, 2016",Charlotte,1,1,121,116,1,53,121,53,27,9,6,11,23,43,10,43,98,14,36,29,62,21,25,146
Phoenix,14,"November 19, 2016",Philadelphia,0,0,105,120,1,48,105,44,18,11,7,15,19,32,12,39,92,6,21,33,71,21,34,104
Cleveland,14,"November 25, 2016",Dallas,1,1,128,90,1,48,128,47,30,9,3,14,16,38,9,43,85,20,43,23,42,22,24,159
Portland,14,"November 18, 2016",New Orleans,0,0,101,113,1,48,101,48,19,2,1,14,21,35,13,33,88,12,34,21,54,23,26,99
Miami,14,"November 23, 2016",Detroit,0,0,84,107,1,48,84,37,19,5,4,14,22,30,7,27,75,7,26,20,49,23,30,80
Indiana,14,"November 20, 2016",Oklahoma City,0,1,115,111,1,53,115,51,23,13,2,22,20,36,15,40,89,11,22,29,67,24,31,126
Toronto,14,"November 21, 2016",L.A.Clippers,0,0,115,123,1,48,115,32,19,10,2,11,31,28,4,40,80,8,19,32,61,27,32,122
Golden State,14,"November 21, 2016",Indiana,0,1,120,83,1,48,120,60,31,9,10,12,17,48,12,40,90,13,36,27,54,27,32,163
Minnesota,14,"November 23, 2016",New Orleans,0,0,96,117,1,48,96,41,23,12,3,17,19,33,8,33,86,3,17,30,69,27,33,99
Boston,15,"November 23, 2016",Brooklyn,0,1,111,92,1,48,111,51,26,13,6,13,22,39,12,45,98,15,38,30,60,6,8,139
Oklahoma City,15,"November 22, 2016",L.A.Lakers,0,0,109,111,1,48,109,40,29,11,6,15,14,29,11,45,92,11,27,34,65,8,11,130
Dallas,15,"November 25, 2016",Cleveland,0,0,90,128,1,48,90,39,29,5,4,13,21,28,11,37,91,8,35,29,56,8,12,96
Washington,15,"November 26, 2016",San Antonio,1,0,100,112,1,48,100,39,21,11,1,12,26,28,11,42,87,6,22,36,65,10,14,111
Indiana,15,"November 21, 2016",Golden State,1,0,83,120,1,48,83,49,13,5,4,11,23,34,15,33,103,6,23,27,80,11,12,72
New Orleans,15,"November 22, 2016",Atlanta,0,1,112,94,1,48,112,40,29,11,9,9,16,35,5,45,86,11,25,34,61,11,12,150
Houston,15,"November 23, 2016",Toronto,1,0,102,115,1,48,102,39,29,6,7,26,22,28,11,38,78,14,42,24,36,12,12,117
New York,15,"November 25, 2016",Charlotte,1,1,113,111,1,53,113,55,26,9,8,16,21,42,13,45,97,11,28,34,69,12,13,142
Phoenix,15,"November 21, 2016",Washington,0,0,101,106,1,48,101,52,22,3,7,21,24,39,13,39,91,11,27,28,64,12,15,109
Miami,15,"November 25, 2016",Memphis,0,1,90,81,1,48,90,44,17,8,8,8,21,34,10,33,85,12,31,21,54,12,18,101
L.A. Lakers,15,"November 22, 2016",Oklahoma City,1,1,111,109,1,48,111,35,25,8,7,17,17,29,6,42,83,14,27,28,56,13,16,125
Milwaukee,15,"November 27, 2016",Orlando,0,1,104,96,1,48,104,53,24,6,6,11,16,43,10,41,86,8,24,33,62,14,20,131
Brooklyn,15,"November 25, 2016",Indiana,0,0,97,118,1,48,97,38,24,8,4,19,17,29,9,36,79,11,34,25,45,14,23,100
Orlando,15,"November 23, 2016",Phoenix,1,0,87,92,1,48,87,44,17,9,8,11,19,33,11,33,91,7,25,26,66,14,23,87
Chicago,15,"November 22, 2016",Denver,0,0,107,110,1,48,107,48,22,6,11,6,18,38,10,43,95,6,18,37,77,15,18,133
Sacramento,15,"November 23, 2016",Oklahoma City,1,1,116,101,1,48,116,46,26,4,1,11,23,35,11,44,94,12,28,32,66,16,17,131
Portland,15,"November 20, 2016",Brooklyn,0,1,129,109,1,48,129,50,23,4,7,15,30,42,8,49,85,15,36,34,49,16,21,157
Toronto,15,"November 23, 2016",Houston,0,1,115,102,1,48,115,38,28,14,7,14,15,23,15,43,88,12,23,31,65,17,21,139
Philadelphia,15,"November 23, 2016",Memphis,1,0,99,104,1,58,99,56,24,9,10,26,32,48,8,35,93,12,36,23,57,17,23,108
Detroit,15,"November 21, 2016",Houston,1,0,96,99,1,48,96,39,19,7,3,14,20,27,12,36,87,7,17,29,70,17,24,92
Charlotte,15,"November 25, 2016",New York,0,0,111,113,1,53,111,46,25,6,4,13,14,36,10,43,93,8,29,35,64,17,27,119
San Antonio,15,"November 23, 2016",Charlotte,0,1,119,114,1,48,119,34,28,9,8,9,18,26,8,44,86,13,31,31,55,18,20,145
Utah,15,"November 20, 2016",Denver,0,0,91,105,1,48,91,49,15,3,6,10,22,35,14,33,85,7,26,26,59,18,23,97
Memphis,15,"November 23, 2016",Philadelphia,0,1,104,99,1,58,104,46,24,13,9,15,28,37,9,38,99,10,29,28,70,18,24,114
Denver,15,"November 23, 2016",Utah,0,0,83,108,1,48,83,49,14,5,5,10,22,35,14,28,88,9,27,19,61,18,31,73
Atlanta,15,"November 23, 2016",Indiana,0,1,96,85,1,48,96,56,17,11,7,21,18,39,17,36,85,5,20,31,65,19,22,114
Minnesota,15,"November 25, 2016",Phoenix,0,1,98,85,1,48,98,39,16,15,8,17,27,28,11,34,85,7,22,27,63,23,25,106
Cleveland,15,"November 27, 2016",Philadelphia,0,1,112,108,1,48,112,46,19,5,3,9,14,32,14,38,92,12,40,26,52,24,28,118
Golden State,15,"November 23, 2016",L.A.Lakers,1,1,149,106,1,48,149,48,47,7,5,10,20,42,6,53,86,19,36,34,50,24,35,202
L.A. Clippers,15,"November 21, 2016",Toronto,1,1,123,115,1,48,123,42,23,5,4,14,24,36,6,39,74,10,25,29,49,35,42,141
Boston,16,"November 25, 2016",San Antonio,1,0,103,109,1,48,103,36,32,8,4,10,21,28,8,42,91,12,34,30,57,7,9,122
Atlanta,16,"November 25, 2016",Utah,0,0,68,95,1,48,68,40,11,8,4,14,16,34,6,26,83,8,25,18,58,8,12,56
Minnesota,16,"November 26, 2016",Golden State,0,0,102,115,1,48,102,32,22,8,3,13,15,24,8,41,89,10,35,31,54,10,12,104
Indiana,16,"November 23, 2016",Atlanta,1,0,85,96,1,48,85,37,16,15,5,18,20,30,7,34,84,7,27,27,57,10,14,86
Golden State,16,"November 25, 2016",L.A.Lakers,0,1,109,85,1,48,109,44,31,10,10,17,21,40,4,43,83,11,28,32,55,12,17,142
Brooklyn,16,"November 27, 2016",Sacramento,1,0,105,122,1,48,105,42,19,7,1,15,21,33,9,38,87,16,39,22,48,13,14,109
Orlando,16,"November 25, 2016",Washington,1,0,91,94,1,48,91,49,18,5,7,19,16,35,14,35,80,7,23,28,57,14,20,100
Toronto,16,"November 25, 2016",Milwaukee,0,1,105,99,1,48,105,36,18,3,5,9,17,27,9,38,80,14,31,24,49,15,19,112
New York,16,"November 26, 2016",Charlotte,0,0,102,107,1,48,102,46,26,9,6,8,27,36,10,37,98,12,32,25,66,16,20,116
Houston,16,"November 25, 2016",Sacramento,0,1,117,104,1,48,117,42,27,8,2,14,19,34,8,40,85,21,50,19,35,16,20,133
Miami,16,"November 26, 2016",Memphis,1,0,107,110,1,48,107,39,18,3,6,9,21,31,8,40,81,11,31,29,50,16,24,115
Dallas,16,"November 27, 2016",New Orleans,1,1,91,81,1,48,91,46,19,7,3,12,18,35,11,32,77,10,27,22,50,17,20,106
Sacramento,16,"November 25, 2016",Houston,1,0,104,117,1,48,104,37,24,7,6,14,18,33,4,39,80,9,32,30,48,17,21,119
Phoenix,16,"November 23, 2016",Orlando,0,1,92,87,1,48,92,44,15,6,7,17,20,38,6,33,73,9,22,24,51,17,22,102
L.A. Lakers,16,"November 23, 2016",Golden State,0,0,106,149,1,48,106,37,22,5,1,11,25,30,7,40,93,8,20,32,73,18,22,103
Philadelphia,16,"November 25, 2016",Chicago,1,0,89,105,1,48,89,48,18,7,8,19,21,40,8,31,78,9,22,22,56,18,22,100
New Orleans,16,"November 23, 2016",Minnesota,1,1,117,96,1,48,117,45,27,10,6,17,21,41,4,45,83,9,24,36,59,18,23,145
Memphis,16,"November 25, 2016",Miami,1,0,81,90,1,48,81,51,14,3,14,17,16,35,16,29,82,4,19,25,63,19,23,89
Milwaukee,16,"November 29, 2016",Cleveland,1,1,118,101,1,48,118,43,27,15,6,17,22,33,10,46,86,7,19,39,67,19,23,148
Chicago,16,"November 25, 2016",Philadelphia,0,1,105,89,1,48,105,51,24,10,5,12,17,40,11,40,90,6,21,34,69,19,26,126
Detroit,16,"November 23, 2016",Miami,1,1,107,84,1,48,107,49,22,8,7,13,19,39,10,40,81,6,19,34,62,21,25,135
Portland,16,"November 22, 2016",New York,0,0,103,107,1,48,103,44,18,5,5,16,13,33,11,38,86,6,22,32,64,21,26,106
Washington,16,"November 28, 2016",Sacramento,1,1,101,95,1,53,101,49,22,11,7,23,23,38,11,35,85,10,25,25,60,21,26,112
Denver,16,"November 25, 2016",Oklahoma City,1,0,129,132,1,53,129,51,34,10,7,16,21,38,13,48,101,12,34,36,67,21,27,156
San Antonio,16,"November 25, 2016",Boston,0,1,109,103,1,48,109,45,24,4,8,16,12,32,13,38,81,11,24,27,57,22,25,128
Utah,16,"November 23, 2016",Denver,1,1,108,83,1,48,108,51,19,4,3,14,25,47,4,39,79,8,26,31,53,22,31,122
Cleveland,16,"November 29, 2016",Milwaukee,0,0,101,118,1,48,101,35,17,7,6,19,19,28,7,32,75,14,39,18,36,23,31,96
L.A. Clippers,16,"November 23, 2016",Dallas,0,1,124,104,1,48,124,43,26,11,4,9,17,37,6,43,85,15,32,28,53,23,31,149
Charlotte,16,"November 26, 2016",New York,1,1,107,102,1,48,107,52,16,3,9,10,14,42,10,35,80,8,22,27,58,29,42,119
Oklahoma City,16,"November 23, 2016",Sacramento,0,0,101,116,1,48,101,38,18,7,7,9,21,33,5,32,76,7,25,25,51,30,38,110
Atlanta,17,"November 27, 2016",L.A.Lakers,0,0,94,109,1,48,94,38,25,5,6,12,19,31,7,39,88,12,35,27,53,4,10,101
Detroit,17,"November 25, 2016",L.A.Clippers,1,1,108,97,1,48,108,42,26,7,0,10,22,33,9,47,90,9,19,38,71,5,7,128
Philadelphia,17,"November 27, 2016",Cleveland,1,0,108,112,1,48,108,50,29,5,5,16,24,37,13,43,92,15,34,28,58,7,10,129
Dallas,17,"November 30, 2016",San Antonio,1,0,87,94,1,48,87,37,16,5,3,11,18,29,8,33,77,10,30,23,47,11,14,90
Indiana,17,"November 25, 2016",Brooklyn,1,1,118,97,1,48,118,47,25,11,5,14,19,38,9,48,87,11,26,37,61,11,16,148
Orlando,17,"November 27, 2016",Milwaukee,1,0,96,104,1,48,96,46,24,6,5,7,17,36,10,38,92,7,28,31,64,13,17,112
Golden State,17,"November 26, 2016",Minnesota,1,1,115,102,1,48,115,45,25,9,8,18,14,33,12,45,81,11,22,34,59,14,17,145
Utah,17,"November 25, 2016",Atlanta,1,1,95,68,1,48,95,55,17,9,9,16,16,46,9,35,80,10,34,25,46,15,18,121
Phoenix,17,"November 25, 2016",Minnesota,1,0,85,98,1,48,85,48,17,11,6,25,26,36,12,32,79,6,26,26,53,15,21,89
L.A. Lakers,17,"November 25, 2016",Golden State,1,0,85,109,1,48,85,45,20,12,3,18,16,31,14,32,90,5,22,27,68,16,23,82
Sacramento,17,"November 27, 2016",Brooklyn,0,1,122,105,1,48,122,45,24,11,3,13,12,36,9,46,86,13,23,33,63,17,22,147
Washington,17,"November 30, 2016",Oklahoma City,0,0,115,126,1,53,115,48,25,8,3,11,25,37,11,44,98,10,28,34,70,17,26,125
Portland,17,"November 23, 2016",Cleveland,0,0,125,137,1,48,125,38,27,6,6,9,23,29,9,47,90,13,29,34,61,18,19,149
New Orleans,17,"November 25, 2016",Portland,0,0,104,119,1,48,104,34,20,3,8,14,14,32,2,36,76,13,23,23,53,19,29,105
L.A. Clippers,17,"November 25, 2016",Detroit,0,0,97,108,1,48,97,32,26,4,6,14,16,26,6,35,73,7,21,28,52,20,26,107
Boston,17,"November 28, 2016",Miami,0,1,112,104,1,48,112,40,26,4,3,9,27,34,6,40,83,11,27,29,56,21,26,128
Houston,17,"November 27, 2016",Portland,0,1,130,114,1,48,130,36,26,7,8,11,23,29,7,46,82,17,36,29,46,21,28,153
Chicago,17,"November 30, 2016",L.A.Lakers,1,0,90,96,1,48,90,46,22,15,11,14,26,32,14,32,91,4,21,28,70,22,29,104
Miami,17,"November 28, 2016",Boston,1,0,104,112,1,48,104,41,24,6,2,13,25,34,7,38,80,6,30,32,50,22,32,112
San Antonio,17,"November 26, 2016",Washington,0,1,112,100,1,48,112,38,22,7,5,14,17,32,6,40,75,9,24,31,51,23,29,129
Oklahoma City,17,"November 25, 2016",Denver,0,1,132,129,1,53,132,40,29,11,4,13,21,33,7,48,95,13,26,35,69,23,29,150
Charlotte,17,"November 28, 2016",Memphis,0,1,104,85,1,48,104,47,24,3,4,13,14,38,9,36,82,9,26,27,56,23,31,115
Minnesota,17,"November 28, 2016",Utah,1,0,103,112,1,48,103,39,26,8,2,14,23,29,10,36,81,7,19,29,62,24,25,118
Milwaukee,17,"December 1, 2016",Brooklyn,0,1,111,93,1,48,111,48,23,8,10,18,18,34,14,36,80,15,34,21,46,24,29,133
Brooklyn,17,"November 29, 2016",L.A.Clippers,1,1,127,122,1,58,127,53,22,10,3,13,23,46,7,45,104,13,38,32,66,24,36,131
New York,17,"November 28, 2016",Oklahoma City,1,0,103,112,1,48,103,40,20,9,11,5,16,28,12,36,91,6,19,30,72,25,28,120
Toronto,17,"November 28, 2016",Philadelphia,1,1,122,95,1,48,122,42,22,11,8,12,14,34,8,42,77,13,19,29,58,25,31,152
Memphis,17,"November 26, 2016",Miami,0,1,110,107,1,48,110,34,23,5,5,6,19,32,2,37,73,9,25,28,48,27,33,129
Denver,17,"November 27, 2016",Phoenix,0,1,120,114,1,48,120,49,21,5,1,12,25,39,10,39,89,13,29,26,60,29,32,131
Cleveland,17,"December 1, 2016",L.A.Clippers,1,0,94,113,1,48,94,36,12,5,3,18,24,30,6,28,69,9,24,19,45,29,39,81
Cleveland,18,"December 2, 2016",Chicago,0,0,105,111,1,48,105,33,30,5,1,18,15,27,6,45,83,10,26,35,57,5,10,113
Indiana,18,"November 27, 2016",L.A.Clippers,1,1,91,70,1,48,91,52,26,8,4,13,21,39,13,40,92,5,19,35,73,6,7,115
Memphis,18,"November 28, 2016",Charlotte,1,0,85,104,1,48,85,42,21,10,4,12,25,34,8,36,89,7,29,29,60,6,13,90
Philadelphia,18,"November 28, 2016",Toronto,0,0,95,122,1,48,95,38,27,9,4,14,21,26,12,36,86,14,34,22,52,9,13,105
Orlando,18,"November 29, 2016",San Antonio,0,1,95,83,1,48,95,40,25,12,4,13,21,31,9,39,86,6,15,33,71,11,12,115
New York,18,"November 30, 2016",Minnesota,0,1,106,104,1,48,106,39,24,8,3,13,26,27,12,41,91,13,32,28,59,11,15,113
Brooklyn,18,"December 1, 2016",Milwaukee,1,0,93,111,1,48,93,40,20,9,9,17,22,28,12,34,89,12,40,22,49,13,16,96
Portland,18,"November 25, 2016",New Orleans,1,1,119,104,1,48,119,52,30,7,5,11,20,40,12,47,100,12,32,35,68,13,17,145
Detroit,18,"November 26, 2016",Oklahoma City,0,0,88,106,1,48,88,32,11,7,1,8,20,26,6,37,82,1,19,36,63,13,17,82
Chicago,18,"December 2, 2016",Cleveland,1,1,111,105,1,48,111,49,31,11,4,12,16,33,16,47,96,3,18,44,78,14,17,142
Dallas,18,"December 1, 2016",Charlotte,0,0,87,97,1,48,87,41,18,6,2,11,25,32,9,32,86,9,31,23,55,14,18,85
Oklahoma City,18,"November 26, 2016",Detroit,1,1,106,88,1,48,106,43,23,4,3,10,16,33,10,42,83,8,23,34,60,14,26,116
Denver,18,"November 30, 2016",Miami,1,0,98,106,1,48,98,55,28,3,7,19,21,41,14,38,91,7,22,31,69,15,24,110
Miami,18,"November 30, 2016",Denver,0,1,106,98,1,48,106,48,26,14,7,6,25,37,11,41,93,9,24,32,69,15,26,132
New Orleans,18,"November 27, 2016",Dallas,0,0,81,91,1,48,81,42,17,8,3,13,19,32,10,30,77,5,20,25,57,16,18,89
Washington,18,"December 2, 2016",San Antonio,0,0,105,107,1,48,105,43,25,13,3,18,26,34,9,41,81,7,11,34,70,16,18,129
Houston,18,"November 29, 2016",Utah,0,0,101,120,1,48,101,38,14,5,6,7,20,23,15,37,91,11,30,26,61,16,22,97
Sacramento,18,"November 28, 2016",Washington,0,0,95,101,1,53,95,44,20,15,4,20,24,31,13,38,93,3,21,35,72,16,26,93
L.A. Lakers,18,"November 27, 2016",Atlanta,1,1,109,94,1,48,109,53,20,7,2,9,15,38,15,42,95,8,20,34,75,17,20,126
Charlotte,18,"November 29, 2016",Detroit,1,0,89,112,1,48,89,40,21,7,5,13,16,35,5,31,78,9,27,22,51,18,21,99
Boston,18,"November 30, 2016",Detroit,1,0,114,121,1,48,114,33,26,6,3,5,17,24,9,40,91,15,42,25,49,19,20,125
Golden State,18,"November 28, 2016",Atlanta,1,1,105,100,1,48,105,41,25,6,10,14,20,34,7,37,85,12,35,25,50,19,24,120
Atlanta,18,"November 28, 2016",Golden State,0,0,100,105,1,48,100,51,20,11,4,18,22,37,14,36,86,7,29,29,57,21,30,109
San Antonio,18,"November 29, 2016",Orlando,1,0,83,95,1,48,83,45,19,9,4,18,17,35,10,28,76,5,20,23,56,22,26,90
L.A. Clippers,18,"November 27, 2016",Indiana,0,0,70,91,1,48,70,40,11,9,4,20,13,34,6,22,70,4,24,18,46,22,27,61
Milwaukee,18,"December 3, 2016",Brooklyn,1,1,112,103,1,48,112,46,25,9,10,11,24,39,7,40,85,6,24,34,61,26,36,136
Toronto,18,"November 30, 2016",Memphis,1,1,120,105,1,48,120,42,23,8,3,18,25,32,10,38,69,16,32,22,37,28,33,142
Utah,18,"November 28, 2016",Minnesota,0,1,112,103,1,48,112,42,19,9,3,12,21,30,12,40,79,4,18,36,61,28,34,128
Phoenix,18,"November 27, 2016",Denver,1,0,114,120,1,48,114,46,11,5,7,11,24,37,9,36,89,11,25,25,64,31,36,114
Minnesota,18,"November 30, 2016",New York,1,0,104,106,1,48,104,40,17,9,5,15,17,29,11,34,77,4,19,30,58,32,39,110
Philadelphia,19,"December 2, 2016",Orlando,1,0,88,105,1,48,88,46,24,3,6,10,18,31,15,36,95,9,32,27,63,7,10,95
Atlanta,19,"November 30, 2016",Phoenix,0,0,107,109,1,48,107,40,20,9,6,20,22,33,7,45,89,9,25,36,64,8,10,116
Denver,19,"December 2, 2016",Houston,1,0,110,128,1,48,110,52,22,5,3,16,20,29,23,46,102,9,30,37,72,9,16,113
L.A. Lakers,19,"November 29, 2016",New Orleans,0,0,88,105,1,48,88,47,26,8,5,12,17,38,9,37,87,5,30,32,57,9,18,103
Detroit,19,"November 29, 2016",Charlotte,0,1,112,89,1,48,112,44,21,7,4,11,19,35,9,45,92,12,28,33,64,10,11,129
Toronto,19,"December 2, 2016",L.A.Lakers,1,1,113,80,1,48,113,44,25,8,5,10,18,37,7,45,83,12,29,33,54,11,13,145
Oklahoma City,19,"November 28, 2016",New York,0,1,112,103,1,48,112,53,25,4,7,14,22,36,17,46,92,8,22,38,70,12,18,135
Boston,19,"December 2, 2016",Sacramento,1,1,97,92,1,48,97,44,25,11,8,13,22,33,11,36,88,11,28,25,60,14,15,119
Dallas,19,"December 3, 2016",Chicago,1,1,107,82,1,48,107,43,31,11,2,10,19,29,14,40,87,13,31,27,56,14,18,133
Washington,19,"December 5, 2016",Brooklyn,0,1,118,113,1,48,118,35,26,17,5,9,22,27,8,45,93,14,34,31,59,14,18,140
Miami,19,"December 1, 2016",Utah,0,1,111,110,1,48,111,40,16,7,2,6,15,27,13,44,86,8,19,36,67,15,19,124
Chicago,19,"December 3, 2016",Dallas,0,0,82,107,1,48,82,43,9,4,5,20,22,32,11,32,71,3,13,29,58,15,21,78
L.A. Clippers,19,"November 29, 2016",Brooklyn,0,0,122,127,1,58,122,57,21,10,3,15,29,46,11,46,109,13,40,33,69,17,22,130
San Antonio,19,"November 30, 2016",Dallas,0,1,94,87,1,48,94,42,16,7,6,11,11,35,7,33,71,11,19,22,52,17,24,109
Phoenix,19,"November 30, 2016",Atlanta,1,1,109,107,1,48,109,41,15,11,4,15,17,28,13,40,89,10,21,30,68,19,25,110
Sacramento,19,"December 2, 2016",Boston,0,0,92,97,1,48,92,51,22,9,10,15,16,37,14,33,87,6,26,27,61,20,25,110
New Orleans,19,"November 29, 2016",L.A.Lakers,1,1,105,88,1,48,105,54,24,10,3,8,17,41,13,38,88,8,31,30,57,21,25,134
Minnesota,19,"December 2, 2016",New York,0,0,114,118,1,48,114,43,25,6,6,14,25,30,13,41,88,10,28,31,60,22,24,131
Memphis,19,"November 30, 2016",Toronto,0,0,105,120,1,48,105,30,16,13,1,15,25,18,12,36,81,11,27,25,54,22,26,101
Cleveland,19,"December 5, 2016",Toronto,0,1,116,112,1,48,116,48,21,4,3,14,21,35,13,40,84,14,32,26,52,22,27,129
Portland,19,"November 27, 2016",Houston,1,0,114,130,1,48,114,35,24,7,2,14,24,27,8,40,83,12,33,28,50,22,29,118
Houston,19,"December 1, 2016",Golden State,0,1,132,127,1,58,132,56,26,11,4,19,28,41,15,48,108,14,44,34,64,22,30,142
Charlotte,19,"December 1, 2016",Dallas,1,1,97,87,1,48,97,39,24,5,6,10,18,35,4,35,74,5,18,30,56,22,31,113
Orlando,19,"December 1, 2016",Memphis,0,0,94,95,1,48,94,42,15,5,10,17,19,35,7,33,74,6,24,27,50,22,31,99
Utah,19,"November 29, 2016",Houston,1,1,120,101,1,48,120,40,23,4,5,8,20,35,5,41,74,15,28,26,46,23,27,147
New York,19,"December 2, 2016",Minnesota,1,1,118,114,1,48,118,43,26,9,6,15,18,32,11,41,86,12,31,29,55,24,30,136
Brooklyn,19,"December 3, 2016",Milwaukee,0,0,103,112,1,48,103,46,21,6,5,14,26,36,10,34,91,11,41,23,50,24,33,101
Golden State,19,"December 1, 2016",Houston,1,0,127,132,1,58,127,54,31,12,7,17,27,41,13,43,104,12,44,31,60,29,37,145
Milwaukee,19,"December 5, 2016",San Antonio,1,0,96,97,1,48,96,43,16,4,7,14,16,36,7,30,73,6,24,24,49,30,34,105
Indiana,19,"November 30, 2016",Portland,0,0,109,131,1,48,109,32,19,3,4,15,14,28,4,36,72,6,14,30,58,31,35,112
Toronto,20,"December 3, 2016",Atlanta,1,1,128,84,1,48,128,48,28,14,7,12,17,36,12,53,92,13,24,40,68,9,11,172
Miami,20,"December 3, 2016",Portland,0,0,92,99,1,48,92,46,23,6,6,13,14,38,8,38,86,6,22,32,64,10,15,107
Denver,20,"December 3, 2016",Utah,0,0,98,105,1,48,98,37,19,7,5,14,21,30,7,37,83,13,24,24,59,11,14,103
Utah,20,"December 1, 2016",Miami,1,0,110,111,1,48,110,31,24,5,8,11,14,26,5,40,73,17,30,23,43,13,17,130
New Orleans,20,"December 2, 2016",L.A.Clippers,1,0,96,114,1,48,96,41,21,5,5,12,14,30,11,39,84,5,20,34,64,13,21,103
Dallas,20,"December 5, 2016",Charlotte,1,0,101,109,1,48,101,35,23,4,2,7,19,26,9,37,89,13,36,24,53,14,18,102
Atlanta,20,"December 2, 2016",Detroit,1,0,85,121,1,48,85,32,22,6,2,7,12,26,6,32,88,6,24,26,64,15,20,79
Phoenix,20,"December 3, 2016",Golden State,0,0,109,138,1,48,109,36,24,8,2,14,29,22,14,41,91,11,32,30,59,16,21,110
Detroit,20,"November 30, 2016",Boston,0,1,121,114,1,48,121,52,28,4,8,11,19,39,13,48,87,9,20,39,67,16,21,158
L.A. Clippers,20,"December 1, 2016",Cleveland,0,1,113,94,1,48,113,47,33,7,3,11,32,33,14,42,89,13,31,29,58,16,24,137
Portland,20,"November 30, 2016",Indiana,1,1,131,109,1,48,131,40,29,13,3,6,23,26,14,51,94,12,32,39,62,17,19,165
Washington,20,"December 6, 2016",Orlando,1,0,116,124,1,48,116,42,20,5,2,10,25,32,10,44,93,11,23,33,70,17,24,119
New York,20,"December 4, 2016",Sacramento,1,1,106,98,1,48,106,58,20,5,9,18,25,44,14,39,88,11,29,28,59,17,24,124
Orlando,20,"December 2, 2016",Philadelphia,0,1,105,88,1,48,105,47,24,8,3,10,20,40,7,37,78,13,26,24,52,18,26,128
Charlotte,20,"December 3, 2016",Minnesota,1,0,120,125,1,53,120,50,30,6,8,14,16,37,13,44,101,14,36,30,65,18,26,135
Minnesota,20,"December 3, 2016",Charlotte,0,1,125,120,1,53,125,51,32,10,10,10,19,37,14,48,106,10,27,38,79,19,22,157
Houston,20,"December 2, 2016",Denver,0,1,128,110,1,48,128,42,25,11,7,11,14,30,12,45,89,17,37,28,52,21,25,154
Philadelphia,20,"December 3, 2016",Boston,1,0,106,107,1,48,106,38,20,5,3,15,23,30,8,35,76,15,33,20,43,21,26,111
San Antonio,20,"December 2, 2016",Washington,1,1,107,105,1,48,107,37,27,11,4,15,17,25,12,39,80,8,20,31,60,21,33,118
Memphis,20,"December 1, 2016",Orlando,1,1,95,94,1,48,95,39,18,9,9,10,25,31,8,33,79,7,18,26,61,22,28,108
Brooklyn,20,"December 5, 2016",Washington,1,0,113,118,1,48,113,51,25,4,5,21,15,38,13,40,81,11,27,29,54,22,30,128
Oklahoma City,20,"November 30, 2016",Washington,1,1,126,115,1,53,126,47,28,10,4,13,22,38,9,46,95,12,30,34,65,22,31,144
Boston,20,"December 3, 2016",Philadelphia,0,1,107,106,1,48,107,37,22,5,3,10,21,31,6,38,76,8,26,30,50,23,29,120
Milwaukee,20,"December 7, 2016",Portland,1,1,115,107,1,48,115,41,19,8,7,10,13,36,5,40,77,10,24,30,53,25,37,131
Cleveland,20,"December 7, 2016",New York,0,1,126,94,1,48,126,46,23,11,4,12,18,36,10,39,80,22,40,17,40,26,31,152
Golden State,20,"December 3, 2016",Phoenix,1,1,138,109,1,48,138,38,37,9,6,17,19,32,6,49,78,14,21,35,57,26,34,174
Sacramento,20,"December 4, 2016",New York,0,0,98,106,1,48,98,50,18,13,5,11,17,33,17,31,96,9,28,22,68,27,31,104
Indiana,20,"December 4, 2016",L.A.Clippers,0,1,111,102,1,48,111,36,21,9,2,9,24,31,5,39,79,5,14,34,65,28,35,123
L.A. Lakers,20,"November 30, 2016",Chicago,0,1,96,90,1,48,96,60,17,12,3,23,24,42,18,33,81,2,8,31,73,28,41,104
Chicago,20,"December 5, 2016",Portland,1,0,110,112,1,48,110,50,16,8,11,15,17,35,15,35,83,7,23,28,60,33,38,127
Orlando,21,"December 4, 2016",Detroit,0,1,98,92,1,48,98,39,23,8,7,10,11,35,4,42,79,7,23,35,56,7,14,121
Atlanta,21,"December 3, 2016",Toronto,0,0,84,128,1,48,84,38,21,7,5,18,13,25,13,35,88,7,28,28,60,7,14,77
Detroit,21,"December 2, 2016",Atlanta,0,1,121,85,1,48,121,54,28,4,3,15,15,43,11,48,89,17,29,31,60,8,12,150
San Antonio,21,"December 5, 2016",Milwaukee,0,1,97,96,1,48,97,46,26,6,5,14,22,34,12,40,93,8,28,32,65,9,14,108
Milwaukee,21,"December 9, 2016",Atlanta,1,0,110,114,1,48,110,43,26,11,5,15,25,34,9,44,94,12,28,32,66,10,14,126
L.A. Lakers,21,"December 2, 2016",Toronto,0,0,80,113,1,48,80,46,16,6,2,16,18,27,19,32,93,6,26,26,67,10,17,66
Boston,21,"December 5, 2016",Houston,0,0,106,107,1,48,106,42,27,7,4,11,20,32,10,42,98,11,32,31,66,11,12,118
Memphis,21,"December 3, 2016",L.A.Lakers,1,1,103,100,1,48,103,43,32,13,7,11,19,29,14,41,88,10,30,31,58,11,15,136
New York,21,"December 6, 2016",Miami,0,1,114,103,1,48,114,53,22,6,6,10,18,35,18,48,98,7,25,41,73,11,16,136
Minnesota,21,"December 6, 2016",San Antonio,1,0,91,105,1,48,91,41,19,4,2,15,20,30,11,36,82,7,20,29,62,12,18,90
Cleveland,21,"December 9, 2016",Miami,1,1,114,84,1,48,114,47,23,7,9,11,16,36,11,46,83,9,24,37,59,13,19,146
Oklahoma City,21,"December 4, 2016",New Orleans,1,1,101,92,1,48,101,59,24,7,5,15,15,48,11,41,89,6,28,35,61,13,26,120
L.A. Clippers,21,"December 2, 2016",New Orleans,0,1,114,96,1,48,114,46,27,7,7,9,18,34,12,45,88,10,24,35,64,14,16,147
New Orleans,21,"December 4, 2016",Oklahoma City,0,0,92,101,1,48,92,51,15,8,6,11,22,39,12,36,98,6,28,30,70,14,19,94
Dallas,21,"December 7, 2016",Sacramento,1,0,89,120,1,48,89,40,17,7,5,20,22,31,9,32,78,10,30,22,48,15,20,87
Washington,21,"December 8, 2016",Denver,1,1,92,85,1,48,92,35,21,11,3,18,20,27,8,35,78,6,19,29,59,16,17,100
Sacramento,21,"December 7, 2016",Dallas,0,1,120,89,1,48,120,41,28,10,3,14,23,35,6,47,84,10,22,37,62,16,21,146
Miami,21,"December 6, 2016",New York,1,0,103,114,1,48,103,46,21,8,4,10,16,30,16,38,89,11,25,27,64,16,27,110
Philadelphia,21,"December 5, 2016",Denver,1,0,98,106,1,48,98,44,20,12,10,17,25,32,12,35,86,11,31,24,55,17,23,110
Portland,21,"December 3, 2016",Miami,1,1,99,92,1,48,99,47,19,6,9,8,17,35,12,36,89,9,24,27,65,18,24,113
Golden State,21,"December 5, 2016",Indiana,1,1,142,106,1,48,142,54,45,12,13,11,22,38,16,54,104,14,37,40,67,20,26,199
Phoenix,21,"December 6, 2016",Utah,0,0,105,112,1,48,105,41,14,5,0,17,28,29,12,39,84,6,18,33,66,21,25,99
Toronto,21,"December 5, 2016",Cleveland,1,0,112,116,1,48,112,33,22,8,5,7,22,23,10,38,88,13,32,25,56,23,27,119
Chicago,21,"December 6, 2016",Detroit,0,0,91,102,1,48,91,45,15,6,7,14,20,36,9,33,75,2,15,31,60,23,32,99
Brooklyn,21,"December 7, 2016",Denver,1,1,116,111,1,48,116,42,18,11,5,15,19,32,10,41,85,9,26,32,59,25,31,127
Charlotte,21,"December 5, 2016",Dallas,0,1,109,101,1,48,109,55,21,2,5,12,19,46,9,40,79,3,18,37,61,26,28,139
Utah,21,"December 3, 2016",Denver,1,1,105,98,1,48,105,40,20,8,3,9,13,33,7,35,78,9,25,26,53,26,28,122
Denver,21,"December 5, 2016",Philadelphia,0,1,106,98,1,48,106,45,17,13,8,19,20,35,10,35,76,10,27,25,49,26,34,121
Houston,21,"December 5, 2016",Boston,1,1,107,106,1,48,107,46,20,8,6,16,14,39,7,34,76,12,38,22,38,27,31,125
Indiana,21,"December 5, 2016",Golden State,0,0,106,142,1,48,106,40,20,10,5,14,21,31,9,35,85,3,15,32,70,33,35,115
Detroit,22,"December 4, 2016",Orlando,1,0,92,98,1,48,92,44,16,8,3,12,12,34,10,38,86,10,27,28,59,6,13,96
Minnesota,22,"December 8, 2016",Toronto,0,0,110,124,1,48,110,43,19,3,2,13,26,27,16,45,88,9,28,36,60,11,15,117
Milwaukee,22,"December 10, 2016",Washington,0,0,105,110,1,48,105,40,22,1,3,20,21,33,7,40,79,13,25,27,54,12,15,109
New York,22,"December 7, 2016",Cleveland,1,0,94,126,1,48,94,43,22,6,3,16,22,30,13,35,87,11,31,24,56,13,15,98
Portland,22,"December 5, 2016",Chicago,0,1,112,110,1,48,112,38,25,9,8,9,27,28,10,45,93,9,24,36,69,13,18,130
Memphis,22,"December 5, 2016",New Orleans,0,1,110,108,1,58,110,61,23,8,4,14,22,48,13,42,104,13,34,29,70,13,21,122
Philadelphia,22,"December 6, 2016",Memphis,0,0,91,96,1,48,91,45,21,5,7,16,27,36,9,32,82,14,41,18,41,13,26,90
San Antonio,22,"December 6, 2016",Minnesota,0,1,105,91,1,48,105,35,21,8,3,11,20,32,3,39,74,11,24,28,50,16,19,123
Miami,22,"December 7, 2016",Atlanta,0,0,95,103,1,48,95,34,20,6,6,16,16,26,8,34,80,11,27,23,53,16,20,95
Denver,22,"December 7, 2016",Brooklyn,0,0,111,116,1,48,111,58,18,7,2,17,24,32,26,42,105,11,37,31,68,16,21,111
Phoenix,22,"December 7, 2016",Indiana,1,0,94,109,1,48,94,40,17,14,4,19,31,31,9,34,85,9,33,25,52,17,18,98
Houston,22,"December 7, 2016",L.A.Lakers,1,1,134,95,1,48,134,52,35,20,2,20,22,37,15,51,94,15,36,36,58,17,21,176
Dallas,22,"December 9, 2016",Indiana,1,1,111,103,1,48,111,34,23,8,1,8,19,28,6,39,80,15,32,24,48,18,24,122
Oklahoma City,22,"December 5, 2016",Atlanta,0,1,102,99,1,48,102,43,26,9,5,19,27,35,8,37,80,10,31,27,49,18,28,113
Utah,22,"December 5, 2016",L.A.Lakers,0,1,107,101,1,48,107,39,26,5,7,12,18,28,11,38,80,13,32,25,48,18,29,119
Cleveland,22,"December 10, 2016",Charlotte,1,1,116,105,1,48,116,40,25,8,2,17,24,33,7,42,73,13,31,29,42,19,28,134
New Orleans,22,"December 5, 2016",Memphis,1,0,108,110,1,58,108,54,21,7,8,11,15,48,6,39,99,10,32,29,67,20,21,126
L.A. Clippers,22,"December 4, 2016",Indiana,1,0,102,111,1,48,102,51,19,5,7,20,24,35,16,36,81,10,30,26,51,20,28,111
Chicago,22,"December 8, 2016",San Antonio,1,1,95,91,1,48,95,50,24,7,5,19,13,40,10,35,80,4,17,31,63,21,27,111
Charlotte,22,"December 7, 2016",Detroit,1,1,87,77,1,48,87,51,13,7,2,5,11,46,5,30,88,6,21,24,67,21,29,89
Brooklyn,22,"December 10, 2016",San Antonio,0,0,101,130,1,48,101,47,21,6,2,16,16,36,11,36,87,7,27,29,60,22,25,107
Washington,22,"December 10, 2016",Milwaukee,1,1,110,105,1,48,110,40,29,10,4,9,17,28,12,40,88,8,21,32,67,22,28,130
Sacramento,22,"December 9, 2016",New York,1,0,100,103,1,48,100,39,24,10,1,7,20,33,6,35,87,7,28,28,59,23,27,111
L.A. Lakers,22,"December 3, 2016",Memphis,0,0,100,103,1,48,100,44,16,7,4,18,18,30,14,35,81,7,21,28,60,23,29,101
Boston,22,"December 7, 2016",Orlando,0,1,117,87,1,48,117,49,29,7,4,10,19,38,11,43,84,7,26,36,58,24,29,150
Golden State,22,"December 7, 2016",L.A.Clippers,0,1,115,98,1,48,115,45,32,12,4,11,24,33,12,42,88,7,30,35,58,24,29,146
Atlanta,22,"December 5, 2016",Oklahoma City,1,0,99,102,1,48,99,36,26,13,3,18,24,29,7,34,77,7,22,27,55,24,32,108
Toronto,22,"December 8, 2016",Minnesota,1,1,124,110,1,48,124,42,25,5,5,8,19,26,16,43,87,12,27,31,60,26,33,142
Orlando,22,"December 6, 2016",Washington,0,1,124,116,1,48,124,43,24,7,13,11,18,35,8,43,83,12,26,31,57,26,36,150
Indiana,22,"December 7, 2016",Phoenix,0,1,109,94,1,48,109,49,16,11,3,18,16,37,12,35,78,7,23,28,55,32,41,118
San Antonio,23,"December 8, 2016",Chicago,0,0,91,95,1,48,91,44,21,11,8,12,18,33,11,39,97,9,28,30,69,4,5,104
Sacramento,23,"December 10, 2016",Utah,0,0,84,104,1,48,84,34,17,10,4,10,14,22,12,34,90,9,26,25,64,7,13,77
Philadelphia,23,"December 8, 2016",New Orleans,0,1,99,88,1,48,99,46,27,8,8,10,20,35,11,39,91,12,40,27,51,9,13,122
Dallas,23,"December 10, 2016",Houston,0,0,87,109,1,48,87,32,18,7,3,9,18,26,6,32,79,11,34,21,45,12,14,89
Milwaukee,23,"December 12, 2016",Toronto,0,0,100,122,1,48,100,37,27,8,3,11,20,25,12,42,89,4,24,38,65,12,17,112
Atlanta,23,"December 7, 2016",Miami,1,1,103,95,1,48,103,47,27,9,9,14,20,33,14,43,88,4,19,39,69,13,15,134
Minnesota,23,"December 9, 2016",Detroit,1,0,90,117,1,48,90,37,19,4,2,12,16,30,7,37,78,3,16,34,62,13,20,92
Detroit,23,"December 6, 2016",Chicago,1,1,102,91,1,48,102,44,24,10,5,9,23,35,9,40,88,8,21,32,67,14,21,121
New Orleans,23,"December 8, 2016",Philadelphia,1,0,88,99,1,48,88,47,18,3,2,12,17,36,11,33,84,7,25,26,59,15,22,88
Boston,23,"December 9, 2016",Toronto,1,0,94,101,1,48,94,46,24,5,4,13,18,38,8,31,83,17,42,14,41,15,22,101
Portland,23,"December 7, 2016",Milwaukee,0,0,107,115,1,48,107,44,25,7,4,15,22,34,10,37,85,17,40,20,45,16,19,121
Miami,23,"December 9, 2016",Cleveland,0,0,84,114,1,48,84,45,18,6,3,13,18,23,22,31,89,6,27,25,62,16,21,80
Phoenix,23,"December 9, 2016",L.A.Lakers,0,1,119,115,1,48,119,44,26,8,9,7,24,35,9,45,95,13,30,32,65,16,21,144
Golden State,23,"December 8, 2016",Utah,0,1,106,99,1,48,106,47,26,10,4,16,23,38,9,39,80,12,29,27,51,16,23,129
Denver,23,"December 8, 2016",Washington,0,0,85,92,1,48,85,45,24,8,2,27,24,31,14,31,76,7,32,24,44,16,24,84
Orlando,23,"December 7, 2016",Boston,1,0,87,117,1,48,87,37,20,7,1,12,26,29,8,30,81,11,26,19,55,16,24,81
Cleveland,23,"December 13, 2016",Memphis,1,1,103,86,1,48,103,46,21,8,4,17,16,36,10,37,81,12,31,25,50,17,23,115
Washington,23,"December 12, 2016",Miami,0,0,101,112,1,48,101,36,17,8,1,14,22,27,9,39,84,5,23,34,61,18,22,100
L.A. Lakers,23,"December 5, 2016",Utah,1,0,101,107,1,48,101,43,15,8,1,10,23,28,15,39,87,5,14,34,73,18,23,105
Charlotte,23,"December 9, 2016",Orlando,1,1,109,88,1,48,109,59,23,4,5,12,13,46,13,41,85,9,22,32,63,18,23,139
L.A. Clippers,23,"December 7, 2016",Golden State,1,0,98,115,1,48,98,46,15,4,2,14,24,29,17,36,91,8,26,28,65,18,24,90
Houston,23,"December 9, 2016",Oklahoma City,0,1,102,99,1,48,102,52,26,9,1,15,24,36,16,36,92,11,42,25,50,19,30,108
New York,23,"December 9, 2016",Sacramento,0,1,103,100,1,48,103,54,22,3,6,16,25,42,12,36,84,10,29,26,55,21,25,120
Toronto,23,"December 9, 2016",Boston,0,1,101,94,1,48,101,50,12,9,2,11,22,42,8,34,82,9,20,25,62,24,27,112
Oklahoma City,23,"December 9, 2016",Houston,1,0,99,102,1,48,99,46,18,9,6,17,19,37,9,34,81,7,28,27,53,24,31,107
Indiana,23,"December 9, 2016",Dallas,0,0,103,111,1,48,103,38,21,5,4,13,18,34,4,32,69,14,25,18,44,25,26,120
Brooklyn,23,"December 12, 2016",Houston,0,0,118,122,1,48,118,41,21,9,4,19,27,35,6,42,80,7,20,35,60,27,36,127
Chicago,23,"December 10, 2016",Miami,1,1,105,100,1,48,105,47,17,8,6,11,15,35,12,38,84,1,8,37,76,28,31,123
Utah,23,"December 6, 2016",Phoenix,1,1,112,105,1,48,112,35,23,7,7,15,23,29,6,36,73,12,27,24,46,28,32,128
Memphis,23,"December 6, 2016",Philadelphia,1,1,96,91,1,48,96,53,18,8,5,13,25,41,12,33,86,2,17,31,69,28,35,107
Boston,24,"December 11, 2016",Oklahoma City,0,0,96,99,1,48,96,40,28,9,4,13,22,28,12,40,90,11,32,29,58,5,8,111
Detroit,24,"December 7, 2016",Charlotte,0,0,77,87,1,48,77,57,21,3,8,12,18,50,7,34,89,4,27,30,62,5,8,96
Milwaukee,24,"December 15, 2016",Chicago,1,1,108,97,1,48,108,42,32,8,5,8,20,29,13,45,95,11,20,34,75,7,13,131
L.A. Clippers,24,"December 10, 2016",New Orleans,1,1,133,105,1,48,133,40,34,10,2,10,22,31,9,54,94,17,36,37,58,8,9,168
Dallas,24,"December 12, 2016",Denver,1,1,112,92,1,48,112,34,22,9,7,9,15,26,8,45,77,12,26,33,51,10,12,141
Orlando,24,"December 9, 2016",Charlotte,0,0,88,109,1,48,88,40,22,6,2,8,17,31,9,34,91,9,34,25,57,11,14,90
Miami,24,"December 10, 2016",Chicago,0,0,100,105,1,48,100,43,25,5,5,12,22,29,14,42,91,5,20,37,71,11,18,110
Golden State,24,"December 10, 2016",Memphis,0,0,89,110,1,48,89,42,15,6,8,23,23,32,10,34,77,9,27,25,50,12,20,86
Sacramento,24,"December 12, 2016",L.A.Lakers,1,1,116,92,1,48,116,47,23,16,6,21,20,34,13,47,84,10,24,37,60,12,21,141
Washington,24,"December 14, 2016",Charlotte,1,1,109,106,1,48,109,41,27,15,3,14,18,29,12,45,87,5,18,40,69,14,17,136
Philadelphia,24,"December 11, 2016",Detroit,0,1,97,79,1,48,97,42,24,11,4,20,13,37,5,38,68,7,17,31,51,14,17,125
Chicago,24,"December 13, 2016",Minnesota,1,0,94,99,1,48,94,42,20,7,6,9,16,29,13,38,87,4,15,34,72,14,19,106
Oklahoma City,24,"December 11, 2016",Boston,1,1,99,96,1,48,99,49,17,9,7,12,9,34,15,41,83,3,21,38,62,14,27,114
Utah,24,"December 8, 2016",Golden State,1,0,99,106,1,48,99,46,20,8,2,15,22,34,12,37,89,10,38,27,51,15,21,102
San Antonio,24,"December 10, 2016",Brooklyn,1,1,130,101,1,48,130,49,38,11,7,10,18,41,8,50,94,14,26,36,68,16,18,179
Houston,24,"December 10, 2016",Dallas,1,1,109,87,1,48,109,48,31,4,1,15,16,38,10,37,74,19,37,18,37,16,22,135
Charlotte,24,"December 10, 2016",Cleveland,0,0,105,116,1,48,105,39,24,5,0,14,24,27,12,39,86,10,27,29,59,17,24,105
New Orleans,24,"December 10, 2016",L.A.Clippers,0,0,105,133,1,48,105,34,25,3,1,16,15,26,8,40,83,8,19,32,64,17,26,100
Phoenix,24,"December 11, 2016",New Orleans,1,0,119,120,1,53,119,57,21,6,3,16,27,43,14,44,96,14,41,30,55,17,26,129
Denver,24,"December 10, 2016",Orlando,0,1,121,113,1,48,121,44,25,2,4,12,20,35,9,47,83,8,19,39,64,19,25,142
Memphis,24,"December 8, 2016",Portland,1,1,88,86,1,48,88,58,13,8,2,12,28,43,15,31,87,6,20,25,67,20,30,91
Cleveland,24,"December 14, 2016",Memphis,0,0,85,93,1,48,85,40,10,11,2,12,16,33,7,28,75,9,25,19,50,20,31,78
L.A. Lakers,24,"December 7, 2016",Houston,0,0,95,134,1,48,95,39,14,13,4,27,22,25,14,34,87,5,20,29,67,22,27,80
Atlanta,24,"December 9, 2016",Milwaukee,0,1,114,110,1,48,114,46,32,7,8,17,11,37,9,40,84,12,34,28,50,22,29,139
Indiana,24,"December 10, 2016",Portland,1,1,118,111,1,48,118,39,24,11,9,13,13,29,10,40,83,15,29,25,54,23,28,140
Toronto,24,"December 12, 2016",Milwaukee,1,1,122,100,1,48,122,48,26,7,2,14,18,32,16,42,83,14,25,28,58,24,28,146
New York,24,"December 11, 2016",L.A.Lakers,0,1,118,112,1,48,118,44,21,9,11,10,15,36,8,41,84,10,22,31,62,26,31,145
Minnesota,24,"December 11, 2016",Golden State,1,0,108,116,1,48,108,51,17,3,2,14,21,35,16,36,81,9,24,27,57,27,36,113
Portland,24,"December 8, 2016",Memphis,0,0,86,88,1,48,86,52,13,6,3,12,23,39,13,25,82,7,28,18,54,29,40,80
Brooklyn,24,"December 14, 2016",L.A.Lakers,1,1,107,97,1,48,107,61,19,7,4,15,26,42,19,33,86,11,35,22,51,30,40,120
Indiana,25,"December 12, 2016",Charlotte,1,1,110,94,1,48,110,42,24,4,11,11,21,37,5,43,88,17,36,26,52,7,10,132
Sacramento,25,"December 14, 2016",Houston,0,0,98,132,1,48,98,40,27,8,7,15,16,28,12,39,92,11,32,28,60,9,11,110
Milwaukee,25,"December 16, 2016",Chicago,0,1,95,69,1,48,95,53,26,7,4,11,14,42,11,38,82,10,25,28,57,9,13,126
San Antonio,25,"December 14, 2016",Boston,1,1,108,101,1,48,108,38,33,9,3,16,17,33,5,44,80,8,22,36,58,12,14,137
Cleveland,25,"December 17, 2016",L.A.Lakers,1,1,119,108,1,48,119,44,30,8,3,8,12,33,11,46,89,15,33,31,56,12,18,147
Dallas,25,"December 14, 2016",Detroit,1,0,85,95,1,48,85,30,19,13,3,11,22,24,6,32,78,8,25,24,53,13,16,90
Miami,25,"December 12, 2016",Washington,1,1,112,101,1,48,112,47,25,6,4,11,18,36,11,45,88,9,26,36,62,13,19,134
Portland,25,"December 10, 2016",Indiana,0,0,111,118,1,48,111,41,22,6,4,17,20,32,9,40,82,16,37,24,45,15,16,124
Denver,25,"December 12, 2016",Dallas,0,0,92,112,1,48,92,43,19,6,3,16,15,23,20,35,83,7,25,28,58,15,18,96
Orlando,25,"December 10, 2016",Denver,1,0,113,121,1,48,113,31,27,7,5,5,18,26,5,43,88,11,27,32,61,16,24,125
Utah,25,"December 10, 2016",Sacramento,1,1,104,84,1,48,104,54,23,9,10,22,16,41,13,37,77,13,29,24,48,17,18,137
Boston,25,"December 14, 2016",San Antonio,0,0,101,108,1,48,101,35,25,12,3,12,13,27,8,37,84,10,31,27,53,17,20,114
Minnesota,25,"December 13, 2016",Chicago,0,1,99,94,1,48,99,49,24,3,8,14,14,34,15,38,86,6,21,32,65,17,22,116
Atlanta,25,"December 13, 2016",Orlando,1,0,120,131,1,48,120,45,29,6,4,15,16,32,13,45,90,11,29,34,61,19,21,142
Detroit,25,"December 9, 2016",Minnesota,0,1,117,90,1,48,117,42,23,6,1,7,23,31,11,42,84,14,29,28,55,19,23,136
Philadelphia,25,"December 14, 2016",Toronto,1,0,114,123,1,48,114,43,29,5,4,14,27,29,14,43,86,9,29,34,57,19,25,132
Oklahoma City,25,"December 13, 2016",Portland,0,0,95,114,1,48,95,44,18,9,3,20,21,28,16,33,87,8,27,25,60,21,28,88
Houston,25,"December 12, 2016",Brooklyn,1,1,122,118,1,48,122,39,23,10,5,14,25,28,11,42,91,17,43,25,48,21,36,121
Brooklyn,25,"December 16, 2016",Orlando,0,0,111,118,1,48,111,45,21,5,6,17,32,39,6,39,83,11,27,28,56,22,26,123
Washington,25,"December 16, 2016",Detroit,1,1,122,108,1,48,122,36,30,6,1,5,23,33,3,44,77,12,25,32,52,22,27,152
Chicago,25,"December 15, 2016",Milwaukee,0,0,97,108,1,48,97,41,23,5,3,16,16,35,6,35,74,5,19,30,55,22,29,107
L.A. Clippers,25,"December 12, 2016",Portland,1,1,121,120,1,48,121,38,26,9,8,11,20,25,13,42,89,11,23,31,66,26,28,142
Memphis,25,"December 10, 2016",Golden State,1,1,110,89,1,48,110,47,23,10,5,10,19,36,11,38,87,8,26,30,61,26,29,133
L.A. Lakers,25,"December 9, 2016",Phoenix,1,0,115,119,1,48,115,49,18,4,2,15,21,39,10,40,87,9,26,31,61,26,34,118
Golden State,25,"December 11, 2016",Minnesota,0,1,116,108,1,48,116,37,30,9,4,8,24,31,6,38,83,13,32,25,51,27,30,140
Charlotte,25,"December 12, 2016",Indiana,0,0,94,110,1,48,94,46,16,8,4,13,15,37,9,28,84,10,26,18,58,28,32,95
Phoenix,25,"December 13, 2016",New York,1,1,113,111,1,53,113,61,13,9,7,17,28,45,16,38,93,9,30,29,63,28,33,126
New Orleans,25,"December 11, 2016",Phoenix,0,1,120,119,1,53,120,49,24,12,4,11,27,35,14,38,97,16,40,22,57,28,35,132
New York,25,"December 13, 2016",Phoenix,0,0,111,113,1,53,111,43,23,10,4,13,27,32,11,38,97,7,20,31,77,28,38,109
Toronto,25,"December 14, 2016",Philadelphia,0,1,123,114,1,48,123,39,21,9,3,9,20,24,15,41,87,10,29,31,58,31,36,135
Chicago,26,"December 16, 2016",Milwaukee,1,0,69,95,1,48,69,50,17,7,3,12,14,31,19,28,92,5,21,23,71,8,15,63
New York,26,"December 15, 2016",Golden State,0,0,90,103,1,48,90,49,19,10,5,11,10,35,14,38,93,5,21,33,72,9,19,97
Detroit,26,"December 11, 2016",Philadelphia,1,0,79,97,1,48,79,34,15,15,2,15,18,24,10,32,82,5,19,27,63,10,14,76
Houston,26,"December 14, 2016",Sacramento,1,1,132,98,1,48,132,47,40,8,5,16,11,39,8,50,85,22,42,28,43,10,16,175
Memphis,26,"December 13, 2016",Cleveland,0,0,86,103,1,48,86,43,19,10,6,15,23,32,11,35,86,4,22,31,64,12,15,95
Utah,26,"December 14, 2016",Oklahoma City,1,1,109,89,1,48,109,38,22,4,6,14,22,34,4,42,72,13,23,29,49,12,15,132
Indiana,26,"December 14, 2016",Miami,0,0,89,95,1,48,89,38,14,8,5,8,21,32,6,33,89,9,27,24,62,14,17,87
Phoenix,26,"December 15, 2016",San Antonio,1,0,92,107,1,48,92,35,15,9,3,13,25,24,11,34,85,10,27,24,58,14,18,86
Orlando,26,"December 13, 2016",Atlanta,0,1,131,120,1,48,131,28,36,7,5,9,17,23,5,51,87,15,34,36,53,14,20,156
Miami,26,"December 14, 2016",Indiana,1,1,95,89,1,48,95,58,23,4,6,15,16,44,14,37,82,7,25,30,57,14,25,115
Golden State,26,"December 13, 2016",New Orleans,0,1,113,109,1,48,113,45,30,6,6,12,12,36,9,42,95,14,34,28,61,15,19,131
Charlotte,26,"December 14, 2016",Washington,0,0,106,109,1,48,106,33,25,7,8,18,18,28,5,38,74,14,33,24,41,16,21,120
New Orleans,26,"December 13, 2016",Golden State,1,0,109,113,1,48,109,45,26,12,11,17,18,39,6,39,82,14,35,25,47,17,21,139
Toronto,26,"December 16, 2016",Atlanta,1,0,121,125,1,48,121,28,20,7,5,9,27,20,8,47,86,10,21,37,65,17,26,124
Dallas,26,"December 16, 2016",Utah,0,0,100,103,1,48,100,27,18,9,0,6,24,20,7,35,77,12,28,23,49,18,21,103
L.A. Lakers,26,"December 11, 2016",New York,1,0,112,118,1,48,112,41,26,7,1,14,22,32,9,42,88,10,28,32,60,18,22,123
Philadelphia,26,"December 16, 2016",L.A.Lakers,1,0,89,100,1,48,89,48,22,7,4,17,17,32,16,32,88,6,31,26,57,19,24,92
Boston,26,"December 16, 2016",Charlotte,1,1,96,88,1,48,96,46,26,7,8,13,15,41,5,34,78,9,28,25,50,19,26,119
Minnesota,26,"December 17, 2016",Houston,1,0,109,111,1,53,109,55,29,9,6,21,21,42,13,41,92,7,21,34,71,20,27,129
Milwaukee,26,"December 20, 2016",Cleveland,1,0,108,114,1,53,108,51,22,6,6,14,21,40,11,40,87,7,27,33,60,21,29,124
Washington,26,"December 18, 2016",L.A.Clippers,1,1,117,110,1,48,117,33,24,10,4,15,24,24,9,43,81,10,19,33,62,21,30,126
Portland,26,"December 12, 2016",L.A.Clippers,0,0,120,121,1,48,120,42,25,6,7,15,24,29,13,44,87,10,21,34,66,22,25,139
Atlanta,26,"December 16, 2016",Toronto,0,1,125,121,1,48,125,44,26,6,6,14,22,29,15,46,86,11,25,35,61,22,32,143
Oklahoma City,26,"December 14, 2016",Utah,0,0,89,109,1,48,89,38,14,4,3,9,18,25,13,30,82,6,19,24,63,23,27,83
Cleveland,26,"December 20, 2016",Milwaukee,0,1,114,108,1,53,114,43,19,5,2,10,21,34,9,37,91,17,40,20,51,23,27,115
Brooklyn,26,"December 18, 2016",Philadelphia,0,0,107,108,1,48,107,43,26,8,5,16,20,36,7,36,81,12,34,24,47,23,31,120
San Antonio,26,"December 15, 2016",Phoenix,0,1,107,92,1,48,107,50,19,6,2,20,20,41,9,39,74,5,16,34,58,24,26,127
L.A. Clippers,26,"December 14, 2016",Orlando,0,1,113,108,1,48,113,42,21,6,5,11,20,35,7,37,74,13,25,24,49,26,37,128
Sacramento,26,"December 16, 2016",Memphis,0,1,96,92,1,48,96,45,18,5,6,11,25,32,13,31,80,7,24,24,56,27,37,100
Denver,26,"December 15, 2016",Portland,1,1,132,120,1,48,132,36,27,10,4,15,28,31,5,43,84,15,31,28,53,31,35,149
Golden State,27,"December 15, 2016",New York,1,1,103,90,1,48,103,57,41,7,10,17,17,42,15,45,96,9,32,36,64,4,8,146
Chicago,27,"December 19, 2016",Detroit,1,1,113,82,1,48,113,46,34,9,5,13,13,37,9,49,82,8,16,41,66,7,7,161
Atlanta,27,"December 17, 2016",Charlotte,1,0,99,107,1,48,99,47,26,4,2,12,18,38,9,40,86,10,26,30,60,9,16,113
Orlando,27,"December 14, 2016",L.A.Clippers,1,0,108,113,1,48,108,39,29,5,1,8,29,27,12,42,89,14,33,28,56,10,20,117
Memphis,27,"December 14, 2016",Cleveland,1,1,93,85,1,48,93,55,22,10,2,17,27,41,14,35,81,12,23,23,58,11,16,114
Sacramento,27,"December 18, 2016",Dallas,0,0,79,99,1,48,79,42,16,7,4,15,21,36,6,30,76,8,31,22,45,11,17,81
Cleveland,27,"December 21, 2016",Milwaukee,1,1,113,102,1,48,113,44,30,3,7,11,20,33,11,43,87,15,27,28,60,12,19,135
Boston,27,"December 18, 2016",Miami,0,1,105,95,1,48,105,37,21,13,2,11,16,26,11,41,90,9,28,32,62,14,19,113
Houston,27,"December 16, 2016",New Orleans,1,1,122,100,1,48,122,57,27,7,4,14,18,44,13,42,94,24,61,18,33,14,19,146
Phoenix,27,"December 17, 2016",Oklahoma City,0,0,101,114,1,48,101,43,16,5,5,16,23,27,16,39,90,8,22,31,68,15,20,98
Charlotte,27,"December 16, 2016",Boston,0,0,88,96,1,48,88,54,21,10,4,12,21,37,17,32,98,8,30,24,68,16,19,96
Toronto,27,"December 18, 2016",Orlando,0,1,109,79,1,48,109,47,20,10,7,10,16,37,10,43,87,7,27,36,60,16,21,134
L.A. Lakers,27,"December 12, 2016",Sacramento,0,0,92,116,1,48,92,39,18,12,3,19,16,22,17,33,84,10,23,23,61,16,21,89
Miami,27,"December 16, 2016",L.A.Clippers,1,0,98,102,1,48,98,47,20,5,5,4,23,37,10,38,93,6,27,32,66,16,25,107
Denver,27,"December 17, 2016",New York,1,1,127,114,1,48,127,41,26,6,7,10,27,30,11,50,90,10,27,40,63,17,29,145
Detroit,27,"December 14, 2016",Dallas,0,1,95,85,1,48,95,50,18,4,2,19,19,40,10,36,71,5,17,31,54,18,22,111
San Antonio,27,"December 18, 2016",New Orleans,1,1,113,100,1,48,113,49,31,6,6,13,15,37,12,42,86,11,22,31,64,18,22,144
Dallas,27,"December 18, 2016",Sacramento,1,1,99,79,1,48,99,44,20,10,6,11,13,38,6,34,77,13,33,21,44,18,22,121
Philadelphia,27,"December 18, 2016",Brooklyn,1,1,108,107,1,48,108,48,23,5,5,17,18,34,14,38,89,12,28,26,61,20,23,118
Indiana,27,"December 15, 2016",New Orleans,0,0,95,102,1,48,95,46,23,6,4,12,21,39,7,36,87,3,21,33,66,20,24,107
Portland,27,"December 13, 2016",Oklahoma City,1,1,114,95,1,48,114,36,23,10,9,13,26,29,7,43,80,8,23,35,57,20,27,135
New Orleans,27,"December 15, 2016",Indiana,1,1,102,95,1,48,102,56,23,6,8,16,16,44,12,36,86,10,27,26,59,20,28,121
Washington,27,"December 19, 2016",Indiana,0,0,105,107,1,48,105,49,19,5,6,15,22,35,14,38,88,8,33,30,55,21,26,114
Utah,27,"December 16, 2016",Dallas,1,1,103,100,1,48,103,41,18,4,3,16,23,33,8,37,65,8,22,29,43,21,27,119
Milwaukee,27,"December 21, 2016",Cleveland,0,0,102,113,1,48,102,39,24,7,8,8,21,33,6,36,77,9,22,27,55,21,29,123
Brooklyn,27,"December 20, 2016",Toronto,0,0,104,116,1,48,104,52,20,9,5,16,23,38,14,36,91,10,35,26,56,22,28,113
L.A. Clippers,27,"December 16, 2016",Miami,0,1,102,98,1,48,102,50,17,1,3,10,20,43,7,36,83,7,25,29,58,23,29,110
Minnesota,27,"December 19, 2016",Phoenix,1,1,115,108,1,48,115,41,26,8,7,19,25,30,11,42,86,7,19,35,67,24,25,133
Oklahoma City,27,"December 17, 2016",Phoenix,1,1,114,101,1,48,114,42,28,12,4,13,21,32,10,41,81,7,16,34,65,25,34,138
New York,27,"December 17, 2016",Denver,0,0,114,127,1,48,114,35,18,6,4,11,27,26,9,35,80,8,23,27,57,36,39,118
Dallas,28,"December 19, 2016",Denver,0,0,107,117,1,48,107,30,21,4,4,12,17,25,5,43,81,14,25,29,56,7,9,114
Charlotte,28,"December 17, 2016",Atlanta,0,1,107,99,1,48,107,43,26,8,3,12,17,36,7,43,88,12,27,31,61,9,13,126
New Orleans,28,"December 16, 2016",Houston,0,0,100,122,1,48,100,47,17,4,6,11,16,34,13,40,98,9,27,31,71,11,20,96
Brooklyn,28,"December 22, 2016",Golden State,1,0,101,117,1,48,101,46,22,6,6,26,15,39,7,38,86,13,35,25,51,12,16,103
Minnesota,28,"December 21, 2016",Atlanta,0,1,92,84,1,48,92,52,21,6,6,17,11,37,15,35,83,9,29,26,54,13,14,111
Denver,28,"December 19, 2016",Dallas,1,1,117,107,1,48,117,40,32,7,0,11,13,33,7,45,79,13,24,32,55,14,18,147
Detroit,28,"December 16, 2016",Washington,0,0,108,122,1,48,108,40,22,3,1,9,19,30,10,42,86,10,28,32,58,14,21,114
Utah,28,"December 18, 2016",Memphis,0,1,82,73,1,48,82,42,18,4,11,15,20,37,5,30,66,8,27,22,39,14,25,95
Miami,28,"December 18, 2016",Boston,1,0,95,105,1,48,95,42,23,7,5,23,20,35,7,36,69,9,24,27,45,14,25,105
Chicago,28,"December 21, 2016",Washington,1,0,97,107,1,48,97,49,25,4,6,14,18,32,17,38,95,6,21,32,74,15,19,106
Houston,28,"December 17, 2016",Minnesota,0,1,111,109,1,53,111,47,25,14,4,16,22,37,10,39,96,17,51,22,45,16,20,124
Philadelphia,28,"December 20, 2016",New Orleans,1,0,93,108,1,48,93,43,18,6,8,13,20,37,6,33,82,11,33,22,49,16,21,101
New York,28,"December 20, 2016",Indiana,1,1,118,111,1,48,118,45,24,6,8,14,18,41,4,44,88,13,23,31,65,17,21,139
L.A. Clippers,28,"December 18, 2016",Washington,0,0,110,117,1,48,110,40,28,7,1,15,23,28,12,43,87,7,23,36,64,17,24,120
Washington,28,"December 21, 2016",Chicago,0,1,107,97,1,48,107,44,23,7,4,10,20,38,6,43,82,3,18,40,64,18,25,129
San Antonio,28,"December 20, 2016",Houston,0,1,102,100,1,48,102,43,21,13,5,19,17,33,10,36,77,12,23,24,54,18,25,117
Atlanta,28,"December 19, 2016",Oklahoma City,0,1,110,108,1,48,110,35,24,5,2,15,20,30,5,41,75,9,23,32,52,19,24,122
Indiana,28,"December 17, 2016",Detroit,0,1,105,90,1,48,105,51,20,6,3,9,16,42,9,40,83,6,19,34,64,19,25,127
Golden State,28,"December 17, 2016",Portland,1,1,135,90,1,48,135,56,36,7,5,15,16,47,9,51,87,14,28,37,59,19,26,181
Oklahoma City,28,"December 19, 2016",Atlanta,1,0,108,110,1,48,108,44,13,8,3,12,18,29,15,39,87,10,35,29,52,20,26,110
Cleveland,28,"December 23, 2016",Brooklyn,1,1,119,99,1,48,119,51,28,12,4,11,20,40,11,45,99,8,35,37,64,21,24,146
L.A. Lakers,28,"December 14, 2016",Brooklyn,0,0,97,107,1,48,97,49,11,8,6,10,26,31,18,35,91,6,27,29,64,21,34,92
Milwaukee,28,"December 23, 2016",Washington,1,1,123,96,1,48,123,41,29,8,6,11,16,33,8,45,80,9,25,36,55,24,27,158
Toronto,28,"December 20, 2016",Brooklyn,1,1,116,104,1,48,116,48,19,13,9,13,21,36,12,42,91,8,18,34,73,24,31,136
Phoenix,28,"December 19, 2016",Minnesota,0,0,108,115,1,48,108,34,16,11,5,17,23,26,8,37,82,9,21,28,61,25,35,102
Memphis,28,"December 16, 2016",Sacramento,1,0,92,96,1,48,92,47,19,7,8,13,31,34,13,29,77,5,25,24,52,29,36,105
Portland,28,"December 15, 2016",Denver,0,0,120,132,1,48,120,41,22,6,4,14,25,26,15,41,88,8,23,33,65,30,36,126
Orlando,28,"December 16, 2016",Brooklyn,1,1,118,111,1,48,118,49,22,8,11,7,17,36,13,39,97,7,29,32,68,33,42,134
Boston,28,"December 20, 2016",Memphis,0,1,112,109,1,53,112,41,22,7,5,11,22,33,8,33,81,12,37,21,44,34,38,124
Sacramento,28,"December 20, 2016",Portland,1,1,126,121,1,48,126,31,20,3,4,10,28,27,4,40,72,10,23,30,49,36,43,135
Orlando,29,"December 18, 2016",Toronto,1,0,79,109,1,48,79,42,13,5,3,19,17,32,10,34,83,3,21,31,62,8,9,73
Chicago,29,"December 23, 2016",Charlotte,0,0,91,103,1,48,91,52,20,5,6,9,20,35,17,38,96,7,22,31,74,8,10,105
New Orleans,29,"December 18, 2016",San Antonio,0,0,100,113,1,48,100,37,29,8,6,10,17,29,8,41,89,10,26,31,63,8,14,116
Atlanta,29,"December 21, 2016",Minnesota,1,0,84,92,1,48,84,35,19,9,8,10,15,27,8,34,82,7,26,27,56,9,13,93
L.A. Clippers,29,"December 20, 2016",Denver,1,1,119,102,1,48,119,37,32,7,2,12,13,32,5,47,86,16,36,31,50,9,13,142
Toronto,29,"December 23, 2016",Utah,0,1,104,98,1,48,104,36,12,12,4,10,19,31,5,43,81,8,21,35,60,10,15,115
Utah,29,"December 20, 2016",Golden State,0,0,74,104,1,48,74,44,13,5,3,23,17,34,10,27,76,9,30,18,46,11,20,58
Denver,29,"December 20, 2016",L.A.Clippers,0,0,102,119,1,48,102,46,22,5,2,12,15,31,15,39,90,11,39,28,51,13,20,107
Portland,29,"December 17, 2016",Golden State,0,0,90,135,1,48,90,31,16,7,4,11,19,24,7,34,86,8,28,26,58,14,20,79
Phoenix,29,"December 21, 2016",Houston,1,0,111,125,1,48,111,44,20,7,6,8,23,30,14,44,93,9,25,35,68,14,20,125
New York,29,"December 22, 2016",Orlando,1,1,106,95,1,48,106,52,26,9,9,15,18,34,18,41,96,9,20,32,76,15,17,130
Golden State,29,"December 20, 2016",Utah,1,1,104,74,1,48,104,50,24,13,3,10,18,41,9,40,90,9,23,31,67,15,17,132
Memphis,29,"December 18, 2016",Utah,1,0,73,82,1,48,73,48,12,8,1,8,28,29,19,28,93,2,23,26,70,15,18,66
Washington,29,"December 23, 2016",Milwaukee,0,0,96,123,1,48,96,30,24,2,2,14,21,25,5,37,79,7,24,30,55,15,18,95
Brooklyn,29,"December 23, 2016",Cleveland,0,0,99,119,1,48,99,44,22,6,7,19,22,37,7,38,85,8,30,30,55,15,18,109
Detroit,29,"December 17, 2016",Indiana,1,0,90,105,1,48,90,40,22,6,1,8,18,30,10,32,84,10,30,22,54,16,22,93
Milwaukee,29,"December 26, 2016",Washington,0,0,102,107,1,48,102,40,27,8,2,13,19,30,10,40,85,6,21,34,64,16,23,114
Sacramento,29,"December 21, 2016",Utah,0,1,94,93,1,48,94,41,13,5,3,10,19,33,8,34,74,10,21,24,53,16,24,98
Indiana,29,"December 19, 2016",Washington,1,1,107,105,1,48,107,41,18,6,6,15,20,32,9,41,87,7,21,34,66,18,21,114
Miami,29,"December 20, 2016",Orlando,1,0,130,136,1,58,130,48,22,4,6,10,30,39,9,50,108,12,30,38,78,18,26,134
L.A. Lakers,29,"December 16, 2016",Philadelphia,0,1,100,89,1,48,100,46,19,11,4,20,21,38,8,36,79,9,30,27,49,19,22,114
Philadelphia,29,"December 23, 2016",Phoenix,0,0,116,123,1,48,116,28,23,7,6,19,31,20,8,42,83,13,31,29,52,19,22,117
Dallas,29,"December 21, 2016",Portland,0,1,96,95,1,48,96,38,14,12,5,10,20,28,10,35,83,7,31,28,52,19,23,103
Charlotte,29,"December 20, 2016",L.A.Lakers,1,1,117,113,1,48,117,44,30,5,2,10,13,28,16,43,94,11,25,32,69,20,24,133
Oklahoma City,29,"December 21, 2016",New Orleans,0,1,121,110,1,48,121,49,22,8,6,10,20,36,13,45,88,11,28,34,60,20,24,149
San Antonio,29,"December 22, 2016",L.A.Clippers,0,0,101,106,1,48,101,54,19,9,7,12,23,37,17,37,92,6,19,31,73,21,25,119
Minnesota,29,"December 23, 2016",Sacramento,1,0,105,109,1,48,105,42,18,5,4,12,21,30,12,36,79,12,32,24,47,21,26,114
Boston,29,"December 22, 2016",Indiana,0,1,109,102,1,48,109,44,19,10,2,10,27,35,9,38,92,10,39,28,53,23,27,116
Cleveland,29,"December 25, 2016",Golden State,1,1,109,108,1,48,109,44,20,14,2,12,19,26,18,37,95,12,35,25,60,23,32,110
Houston,29,"December 20, 2016",San Antonio,1,0,100,102,1,48,100,51,22,10,5,16,17,31,20,35,92,6,38,29,54,24,27,112
Dallas,30,"December 23, 2016",L.A.Clippers,0,1,90,88,1,48,90,42,21,13,4,12,14,28,14,37,87,7,29,30,58,9,15,102
L.A. Lakers,30,"December 17, 2016",Cleveland,0,0,108,119,1,48,108,41,30,3,2,11,16,31,10,41,86,16,37,25,49,10,13,125
Sacramento,30,"December 23, 2016",Minnesota,0,1,109,105,1,48,109,34,27,7,3,11,23,28,6,42,80,15,29,27,51,10,14,127
Detroit,30,"December 19, 2016",Chicago,0,0,82,113,1,48,82,32,19,8,3,11,8,22,10,34,83,3,23,31,60,11,13,82
Golden State,30,"December 22, 2016",Brooklyn,0,1,117,101,1,48,117,51,29,19,7,12,19,40,11,47,104,12,37,35,67,11,14,151
Milwaukee,30,"December 28, 2016",Detroit,0,1,119,94,1,48,119,38,36,8,5,7,14,35,3,48,84,11,22,37,62,12,16,159
Philadelphia,30,"December 26, 2016",Sacramento,0,0,100,102,1,48,100,38,20,13,5,22,23,30,8,39,79,9,25,30,54,13,18,109
Miami,30,"December 22, 2016",L.A.Lakers,1,1,115,107,1,48,115,47,25,7,6,12,15,37,10,45,84,11,22,34,62,14,21,142
Chicago,30,"December 25, 2016",San Antonio,0,0,100,119,1,48,100,38,20,9,1,14,19,24,14,39,86,7,18,32,68,15,20,102
Washington,30,"December 26, 2016",Milwaukee,1,1,107,102,1,48,107,40,29,7,5,16,16,33,7,40,79,12,29,28,50,15,20,128
Houston,30,"December 21, 2016",Phoenix,0,1,125,111,1,48,125,37,30,4,8,11,22,28,9,46,86,18,38,28,48,15,26,142
L.A. Clippers,30,"December 22, 2016",San Antonio,1,1,106,101,1,48,106,42,18,8,6,13,22,35,7,39,84,11,28,28,56,17,22,117
Utah,30,"December 21, 2016",Sacramento,1,0,93,94,1,48,93,43,19,7,6,11,22,36,7,33,74,9,27,24,47,18,22,112
Minnesota,30,"December 25, 2016",Oklahoma City,0,0,100,112,1,48,100,36,19,11,2,12,21,25,11,39,83,4,12,35,71,18,23,107
New Orleans,30,"December 20, 2016",Philadelphia,0,1,108,93,1,48,108,56,28,2,3,11,16,40,16,40,93,10,17,30,76,18,26,125
Cleveland,30,"December 26, 2016",Detroit,0,0,90,106,1,48,90,47,19,8,3,21,23,37,10,30,79,11,28,19,51,19,23,93
Toronto,30,"December 26, 2016",Portland,0,1,95,91,1,48,95,52,17,11,4,12,12,38,14,32,95,12,34,20,61,19,24,99
San Antonio,30,"December 23, 2016",Portland,0,1,110,90,1,48,110,45,19,9,3,12,17,32,13,39,78,12,20,27,58,20,21,134
Boston,30,"December 23, 2016",Oklahoma City,1,0,112,117,1,48,112,39,29,8,2,12,29,29,10,41,93,9,28,32,65,21,26,121
Memphis,30,"December 20, 2016",Boston,1,0,109,112,1,53,109,52,23,10,3,13,30,35,17,38,94,12,30,26,64,21,26,123
Orlando,30,"December 20, 2016",Miami,0,1,136,130,1,58,136,47,24,3,5,11,25,41,6,52,105,11,22,41,83,21,31,141
New York,30,"December 25, 2016",Boston,1,0,114,119,1,48,114,49,11,5,6,17,23,31,18,41,87,8,23,33,64,24,27,119
Charlotte,30,"December 23, 2016",Chicago,1,1,103,91,1,48,103,48,25,6,13,10,8,36,12,37,84,5,18,32,66,24,28,134
Oklahoma City,30,"December 23, 2016",Boston,0,1,117,112,1,48,117,44,27,5,6,13,21,34,10,41,80,11,26,30,54,24,36,135
Brooklyn,30,"December 26, 2016",Charlotte,1,1,120,118,1,48,120,39,26,4,8,15,21,35,4,40,75,15,31,25,44,25,31,141
Denver,30,"December 23, 2016",Atlanta,1,0,108,109,1,48,108,45,27,3,7,15,29,38,7,37,78,8,25,29,53,26,35,125
Indiana,30,"December 20, 2016",New York,0,0,111,118,1,48,111,44,22,10,5,9,14,33,11,39,91,6,23,33,68,27,33,125
Atlanta,30,"December 23, 2016",Denver,0,1,109,108,1,48,109,41,26,10,4,8,25,31,10,37,86,8,25,29,61,27,33,127
Phoenix,30,"December 23, 2016",Philadelphia,1,1,123,116,1,48,123,43,25,7,6,20,24,32,11,42,79,12,26,30,53,27,37,137
Portland,30,"December 20, 2016",Sacramento,0,0,121,126,1,48,121,41,30,5,4,8,31,26,15,44,86,4,27,40,59,29,40,140
Philadelphia,31,"December 29, 2016",Utah,0,0,83,100,1,48,83,41,16,6,1,15,16,28,13,35,87,6,24,29,63,7,8,79
L.A. Clippers,31,"December 23, 2016",Dallas,1,0,88,90,1,48,88,41,17,9,4,20,16,35,6,34,74,13,29,21,45,7,11,95
Miami,31,"December 23, 2016",New Orleans,0,0,87,91,1,48,87,59,19,4,4,13,20,48,11,36,87,8,19,28,68,7,13,103
L.A. Lakers,31,"December 20, 2016",Charlotte,0,0,113,117,1,48,113,40,29,5,12,12,20,30,10,44,90,16,33,28,57,9,11,139
Milwaukee,31,"December 30, 2016",Minnesota,0,0,99,116,1,48,99,30,22,4,4,14,19,22,8,40,74,8,18,32,56,11,17,105
Orlando,31,"December 22, 2016",New York,0,0,95,106,1,48,95,41,21,7,7,16,14,31,10,39,90,5,27,34,63,12,16,100
Brooklyn,31,"December 28, 2016",Chicago,0,0,99,101,1,48,99,38,21,9,5,14,22,28,10,37,86,13,33,24,53,12,16,105
Atlanta,31,"December 26, 2016",Minnesota,0,0,90,104,1,48,90,46,20,8,7,19,19,29,17,35,83,8,32,27,51,12,17,99
Houston,31,"December 23, 2016",Memphis,0,0,109,115,1,48,109,41,27,5,3,14,22,31,10,38,89,20,52,18,37,13,15,118
San Antonio,31,"December 25, 2016",Chicago,1,1,119,100,1,48,119,43,30,7,3,13,19,32,11,48,85,9,18,39,67,14,19,147
Minnesota,31,"December 26, 2016",Atlanta,1,1,104,90,1,48,104,40,26,11,3,14,19,29,11,37,82,15,31,22,51,15,18,122
Boston,31,"December 25, 2016",New York,0,1,119,114,1,48,119,39,25,10,3,6,20,27,12,45,93,14,36,31,57,15,20,137
Memphis,31,"December 21, 2016",Detroit,0,1,98,86,1,48,98,38,25,9,5,8,26,31,7,35,82,12,30,23,52,16,19,117
Sacramento,31,"December 26, 2016",Philadelphia,1,1,102,100,1,48,102,42,24,11,4,19,19,29,13,39,87,7,25,32,62,17,21,112
Dallas,31,"December 26, 2016",New Orleans,0,0,104,111,1,48,104,32,27,4,1,10,22,28,4,37,75,13,32,24,43,17,22,115
Utah,31,"December 23, 2016",Toronto,1,0,98,104,1,48,98,40,21,7,2,16,16,31,9,35,79,10,27,25,52,18,21,105
Toronto,31,"December 28, 2016",Golden State,0,0,111,121,1,48,111,45,24,13,6,7,18,26,19,40,103,13,35,27,68,18,22,125
New Orleans,31,"December 21, 2016",Oklahoma City,1,0,110,121,1,48,110,34,25,4,3,9,18,27,7,42,88,8,20,34,68,18,23,116
Oklahoma City,31,"December 25, 2016",Minnesota,1,1,112,100,1,48,112,42,26,8,4,15,24,33,9,42,82,8,24,34,58,20,24,133
Chicago,31,"December 26, 2016",Indiana,1,1,90,85,1,48,90,47,17,10,3,12,15,31,16,32,83,6,25,26,58,20,28,96
New York,31,"December 28, 2016",Atlanta,0,0,98,102,1,53,98,55,20,8,7,17,23,41,14,35,93,7,27,28,66,21,26,108
Portland,31,"December 21, 2016",Dallas,1,0,95,96,1,48,95,43,15,6,4,17,20,34,9,32,72,10,27,22,45,21,28,99
Golden State,31,"December 23, 2016",Detroit,0,1,119,113,1,48,119,41,35,9,2,22,21,37,4,43,77,11,27,32,50,22,24,148
Charlotte,31,"December 26, 2016",Brooklyn,0,0,118,120,1,48,118,44,23,11,3,11,24,32,12,44,94,8,26,36,68,22,25,135
Phoenix,31,"December 26, 2016",Houston,0,0,115,131,1,48,115,53,17,14,6,17,25,37,16,43,101,7,30,36,71,22,27,125
Denver,31,"December 26, 2016",L.A.Clippers,0,1,106,102,1,48,106,51,22,10,1,14,18,40,11,36,82,11,31,25,51,23,28,125
Cleveland,31,"December 29, 2016",Boston,1,1,124,118,1,48,124,46,29,7,3,18,16,33,13,43,83,14,38,29,45,24,33,142
Indiana,31,"December 22, 2016",Boston,1,0,102,109,1,48,102,52,20,5,3,19,21,43,9,35,82,7,23,28,59,25,29,112
Washington,31,"December 28, 2016",Indiana,1,1,111,105,1,48,111,54,21,8,1,18,27,39,15,38,78,8,22,30,56,27,37,127
Detroit,31,"December 21, 2016",Memphis,1,0,86,98,1,48,86,47,17,2,3,17,18,36,11,26,72,6,23,20,49,28,37,83
Indiana,32,"December 26, 2016",Chicago,0,0,85,90,1,48,85,41,26,5,5,16,21,31,10,34,81,9,25,25,56,8,10,97
Orlando,32,"December 23, 2016",L.A.Lakers,1,1,109,90,1,48,109,47,25,10,11,14,20,40,7,45,89,11,27,34,62,8,14,138
Portland,32,"December 23, 2016",San Antonio,1,0,90,110,1,48,90,33,21,8,2,15,19,23,10,35,79,12,30,23,49,8,16,87
Denver,32,"December 28, 2016",Minnesota,1,1,105,103,1,48,105,38,29,6,4,15,17,30,8,42,81,10,28,32,53,11,14,125
Minnesota,32,"December 28, 2016",Denver,0,0,103,105,1,48,103,43,29,8,3,8,15,27,16,42,94,7,25,35,69,12,17,121
Washington,32,"December 30, 2016",Brooklyn,1,1,118,95,1,48,118,44,28,12,7,19,21,36,8,47,83,11,22,36,61,13,14,153
L.A. Lakers,32,"December 22, 2016",Miami,0,0,107,115,1,48,107,40,18,7,2,13,14,31,9,40,90,14,38,26,52,13,15,109
New Orleans,32,"December 23, 2016",Miami,1,1,91,87,1,48,91,52,17,8,9,9,20,41,11,33,89,11,28,22,61,14,21,105
New York,32,"December 30, 2016",New Orleans,0,0,92,104,1,48,92,50,18,7,6,14,18,40,10,35,93,7,23,28,70,15,16,100
Miami,32,"December 27, 2016",Oklahoma City,1,0,94,106,1,48,94,32,14,10,4,12,23,23,9,36,82,7,23,29,59,15,21,90
Utah,32,"December 27, 2016",L.A.Lakers,0,1,102,100,1,48,102,39,19,6,4,19,18,25,14,38,75,9,26,29,49,17,24,107
Oklahoma City,32,"December 27, 2016",Miami,0,1,106,94,1,48,106,46,21,3,4,17,21,32,14,42,82,5,19,37,63,17,25,115
Detroit,32,"December 23, 2016",Golden State,1,0,113,119,1,48,113,36,22,12,3,13,22,31,5,43,85,10,29,33,56,17,28,120
Charlotte,32,"December 28, 2016",Orlando,0,1,120,101,1,48,120,46,25,8,3,13,13,36,10,46,84,10,24,36,60,18,19,150
L.A. Clippers,32,"December 25, 2016",L.A.Lakers,0,0,102,111,1,48,102,42,24,9,5,15,20,32,10,37,85,10,29,27,56,18,22,115
Sacramento,32,"December 28, 2016",Portland,0,0,89,102,1,48,89,39,20,8,3,11,20,33,6,31,79,9,28,22,51,18,23,95
Boston,32,"December 27, 2016",Memphis,1,1,113,103,1,48,113,47,30,6,7,17,24,33,14,41,85,12,31,29,54,19,21,140
Phoenix,32,"December 28, 2016",San Antonio,0,0,98,119,1,48,98,33,20,11,4,21,25,26,7,36,74,7,16,29,58,19,24,102
San Antonio,32,"December 28, 2016",Phoenix,1,1,119,98,1,48,119,46,20,11,7,16,20,30,16,47,87,5,17,42,70,20,25,142
Memphis,32,"December 23, 2016",Houston,1,1,115,109,1,48,115,37,23,9,3,10,16,29,8,41,81,13,25,28,56,20,25,132
Dallas,32,"December 27, 2016",Houston,1,0,107,123,1,48,107,38,22,6,5,9,18,26,12,36,87,15,38,21,49,20,25,113
Brooklyn,32,"December 30, 2016",Washington,0,0,95,118,1,48,95,32,18,9,0,21,16,26,6,32,74,10,25,22,49,21,25,87
Cleveland,32,"December 31, 2016",Charlotte,0,1,121,109,1,48,121,35,17,6,1,6,17,27,8,43,85,14,31,29,54,21,25,128
Atlanta,32,"December 28, 2016",New York,1,1,102,98,1,53,102,56,19,8,3,13,19,38,18,37,102,7,27,30,75,21,27,104
Milwaukee,32,"December 31, 2016",Chicago,0,1,116,96,1,48,116,43,29,7,8,12,19,35,8,43,76,9,15,34,61,21,27,152
Toronto,32,"December 29, 2016",Phoenix,0,0,91,99,1,48,91,43,10,12,5,18,24,34,9,30,75,7,27,23,48,24,29,93
Houston,32,"December 26, 2016",Phoenix,1,1,131,115,1,48,131,47,28,11,4,20,22,37,10,46,92,15,43,31,49,24,30,149
Golden State,32,"December 25, 2016",Cleveland,0,0,108,109,1,48,108,42,25,8,4,19,24,37,5,37,77,9,30,28,47,25,29,124
Chicago,32,"December 28, 2016",Brooklyn,1,1,101,99,1,48,101,55,20,8,9,18,17,37,18,35,88,3,13,32,75,28,29,121
Philadelphia,32,"December 30, 2016",Denver,0,1,124,122,1,48,124,44,25,5,5,11,33,29,15,38,87,16,33,22,54,32,40,135
Miami,33,"December 29, 2016",Charlotte,0,0,82,91,1,48,82,46,26,6,10,16,19,42,4,33,82,10,28,23,54,6,13,98
Detroit,33,"December 26, 2016",Cleveland,1,1,106,90,1,48,106,46,25,12,4,12,19,35,11,41,93,16,28,25,65,8,15,122
Washington,33,"January 2, 2017",Houston,0,0,91,101,1,48,91,45,23,9,2,17,21,38,7,38,87,6,26,32,61,9,12,101
Dallas,33,"December 29, 2016",L.A.Lakers,0,1,101,89,1,48,101,42,24,8,2,15,17,32,10,38,77,14,31,24,46,11,14,120
Orlando,33,"December 26, 2016",Memphis,1,1,112,102,1,48,112,44,23,5,3,9,21,35,9,44,87,13,26,31,61,11,16,130
Portland,33,"December 26, 2016",Toronto,1,0,91,95,1,48,91,54,22,8,4,18,22,43,11,35,83,8,23,27,60,13,18,108
Charlotte,33,"December 29, 2016",Miami,1,1,91,82,1,48,91,54,18,9,9,8,11,43,11,36,93,5,26,31,67,14,18,112
Golden State,33,"December 28, 2016",Toronto,1,1,121,111,1,48,121,51,33,4,9,20,16,42,9,46,81,14,23,32,58,15,18,160
L.A. Clippers,33,"December 26, 2016",Denver,1,0,102,106,1,48,102,38,22,6,7,11,19,34,4,39,84,9,25,30,59,15,20,114
Milwaukee,33,"January 2, 2017",Oklahoma City,1,1,98,94,1,48,98,39,21,4,4,10,17,32,7,38,79,7,19,31,60,15,24,106
Utah,33,"December 29, 2016",Philadelphia,1,1,100,83,1,48,100,43,21,9,6,14,11,34,9,35,73,15,26,20,47,15,28,114
Cleveland,33,"January 2, 2017",New Orleans,1,1,90,82,1,48,90,56,16,9,5,11,13,45,11,34,90,6,31,28,59,16,22,103
Phoenix,33,"December 29, 2016",Toronto,1,1,99,91,1,48,99,47,20,10,4,20,28,35,12,37,83,9,21,28,62,16,23,107
Minnesota,33,"December 30, 2016",Milwaukee,1,1,116,99,1,48,116,34,30,8,5,11,17,26,8,43,77,13,25,30,52,17,21,144
Brooklyn,33,"January 2, 2017",Utah,1,0,89,101,1,48,89,44,13,5,5,15,20,36,8,33,78,6,27,27,51,17,23,90
New York,33,"December 31, 2016",Houston,0,0,122,129,1,48,122,48,21,7,3,7,20,35,13,47,105,10,32,37,73,18,25,129
Atlanta,33,"December 30, 2016",Detroit,1,1,105,98,1,48,105,44,29,10,2,15,21,32,12,39,88,8,26,31,62,19,25,120
Boston,33,"December 29, 2016",Cleveland,0,0,118,124,1,48,118,29,26,15,4,11,23,23,6,43,85,12,37,31,48,20,21,138
L.A. Lakers,33,"December 23, 2016",Orlando,0,0,90,109,1,48,90,47,16,8,6,16,14,34,13,31,87,8,23,23,64,20,24,91
Philadelphia,33,"January 3, 2017",Minnesota,1,1,93,91,1,48,93,48,19,10,7,16,21,36,12,33,85,7,32,26,53,20,25,104
San Antonio,33,"December 30, 2016",Portland,1,1,110,94,1,48,110,48,22,7,5,16,18,37,11,39,78,11,22,28,56,21,25,133
Memphis,33,"December 26, 2016",Orlando,0,0,102,112,1,48,102,35,17,7,4,6,19,32,3,35,76,10,25,25,51,22,28,112
Houston,33,"December 27, 2016",Dallas,0,1,123,107,1,48,123,48,23,7,5,16,22,38,10,41,78,17,32,24,46,24,28,149
Indiana,33,"December 28, 2016",Washington,0,0,105,111,1,48,105,34,24,10,4,13,29,29,5,35,79,11,28,24,51,24,29,115
Sacramento,33,"December 31, 2016",Memphis,1,0,98,112,1,48,98,39,17,6,3,12,12,28,11,31,72,11,28,20,44,25,28,107
New Orleans,33,"December 26, 2016",Dallas,1,1,111,104,1,48,111,41,24,6,3,10,19,36,5,37,70,12,25,25,45,25,30,137
Chicago,33,"December 30, 2016",Indiana,0,0,101,111,1,48,101,47,17,8,5,13,23,32,15,35,84,6,23,29,61,25,31,110
Oklahoma City,33,"December 29, 2016",Memphis,0,0,80,114,1,48,80,39,9,5,7,18,18,25,14,25,74,4,22,21,52,26,38,61
Toronto,33,"January 1, 2017",L.A.Lakers,0,1,123,114,1,48,123,40,18,5,9,16,25,35,5,42,75,10,17,32,58,29,32,143
Denver,33,"December 30, 2016",Philadelphia,1,0,122,124,1,48,122,45,29,5,1,10,26,34,11,39,84,11,27,28,57,33,41,139
Phoenix,34,"December 31, 2016",Utah,0,0,86,91,1,48,86,41,9,6,2,9,21,32,9,36,87,7,17,29,70,7,10,81
Miami,34,"December 30, 2016",Boston,0,0,114,117,1,48,114,39,35,7,8,12,20,30,9,48,90,11,28,37,62,7,10,146
Orlando,34,"December 28, 2016",Charlotte,1,0,101,120,1,48,101,34,25,7,7,14,15,25,9,42,87,9,35,33,52,8,10,113
Brooklyn,34,"January 5, 2017",Indiana,0,0,109,121,1,48,109,45,22,5,8,13,17,37,8,41,90,17,38,24,52,10,13,124
Detroit,34,"December 28, 2016",Milwaukee,1,0,94,119,1,48,94,44,28,4,1,10,12,33,11,39,88,6,24,33,64,10,16,106
Washington,34,"January 3, 2017",Dallas,0,0,105,113,1,48,105,38,27,6,7,9,19,33,5,41,92,11,30,30,62,12,14,121
Minnesota,34,"January 1, 2017",Portland,1,0,89,95,1,48,89,47,21,11,5,16,25,34,13,35,87,7,23,28,64,12,18,99
New Orleans,34,"December 28, 2016",L.A.Clippers,1,1,102,98,1,48,102,45,23,11,6,6,16,37,8,40,87,10,29,30,58,12,21,125
Dallas,34,"December 30, 2016",Golden State,0,0,99,108,1,48,99,40,22,11,7,10,12,29,11,39,93,8,32,31,61,13,15,113
Golden State,34,"December 30, 2016",Dallas,1,1,108,99,1,48,108,43,31,5,4,13,12,39,4,42,84,11,33,31,51,13,15,134
L.A. Clippers,34,"December 28, 2016",New Orleans,0,0,98,102,1,48,98,59,15,6,4,11,20,42,17,37,96,11,37,26,59,13,18,107
Utah,34,"December 31, 2016",Phoenix,1,1,91,86,1,48,91,46,17,3,4,15,16,40,6,35,73,8,20,27,53,13,20,101
Denver,34,"January 2, 2017",Golden State,0,0,119,127,1,48,119,48,33,10,2,14,21,32,16,48,101,9,35,39,66,14,18,141
Toronto,34,"January 3, 2017",San Antonio,0,0,82,110,1,48,82,43,8,8,4,12,17,29,14,31,83,4,18,27,65,16,22,75
Atlanta,34,"January 1, 2017",San Antonio,1,1,114,112,1,53,114,46,25,6,6,11,21,35,11,42,92,14,28,28,64,16,27,125
Sacramento,34,"January 3, 2017",Denver,0,1,120,113,1,48,120,33,26,7,2,8,13,28,5,46,88,11,29,35,59,17,18,137
New York,34,"January 2, 2017",Orlando,1,0,103,115,1,48,103,46,18,7,6,18,17,30,16,39,83,8,21,31,62,17,24,111
Cleveland,34,"January 4, 2017",Chicago,1,0,94,106,1,48,94,44,13,6,2,15,16,28,16,34,83,8,25,26,58,18,24,89
San Antonio,34,"January 1, 2017",Atlanta,0,0,112,114,1,53,112,47,27,5,6,12,21,38,9,42,90,9,27,33,63,19,22,134
Portland,34,"December 28, 2016",Sacramento,1,1,102,89,1,48,102,45,19,6,4,15,16,40,5,35,74,12,25,23,49,20,22,120
Charlotte,34,"December 31, 2016",Cleveland,1,0,109,121,1,48,109,39,24,3,7,11,19,29,10,40,78,9,24,31,54,20,23,130
Chicago,34,"December 31, 2016",Milwaukee,1,0,96,116,1,48,96,37,23,9,5,11,21,23,14,33,83,10,27,23,56,20,28,101
Memphis,34,"December 27, 2016",Boston,0,0,103,113,1,48,103,37,22,14,5,11,18,24,13,37,88,9,30,28,58,20,29,110
Milwaukee,34,"January 4, 2017",New York,0,1,105,104,1,48,105,42,20,7,5,13,15,35,7,37,78,9,28,28,50,22,31,116
Philadelphia,34,"January 6, 2017",Boston,0,0,106,110,1,48,106,41,30,9,11,15,23,37,4,37,79,9,28,28,51,23,26,137
L.A. Lakers,34,"December 25, 2016",L.A.Clippers,1,1,111,102,1,48,111,48,18,7,4,13,21,35,13,40,84,8,25,32,59,23,30,124
Boston,34,"December 30, 2016",Miami,1,1,117,114,1,48,117,30,28,6,2,13,11,25,5,38,74,17,32,21,42,24,29,129
Indiana,34,"December 30, 2016",Chicago,1,1,111,101,1,48,111,42,26,7,6,11,22,34,8,39,81,7,19,32,62,26,30,135
Oklahoma City,34,"December 31, 2016",L.A.Clippers,1,1,114,88,1,48,114,44,25,9,6,9,20,36,8,37,78,10,29,27,49,30,35,143
Houston,34,"December 30, 2016",L.A.Clippers,1,1,140,116,1,48,140,45,29,12,5,13,17,36,9,45,81,14,40,31,41,36,43,175
New York,35,"January 4, 2017",Milwaukee,1,0,104,105,1,48,104,46,26,9,3,13,19,31,15,42,94,13,28,29,66,7,12,118
Washington,35,"January 6, 2017",Minnesota,1,1,112,105,1,48,112,33,31,3,7,13,18,28,5,46,79,12,22,34,57,8,9,139
Orlando,35,"January 1, 2017",Indiana,0,0,104,117,1,48,104,42,25,6,7,10,22,32,10,42,97,10,38,32,59,10,11,118
San Antonio,35,"January 3, 2017",Toronto,1,1,110,82,1,48,110,44,32,7,15,15,18,37,7,43,78,13,24,30,54,11,15,154
Denver,35,"January 3, 2017",Sacramento,1,0,113,120,1,48,113,34,29,6,4,14,18,28,6,41,83,18,38,23,45,13,13,130
L.A. Clippers,35,"December 30, 2016",Houston,0,0,116,140,1,48,116,38,22,8,4,15,25,27,11,45,96,13,33,32,63,13,16,119
Atlanta,35,"January 4, 2017",Orlando,0,1,111,92,1,48,111,39,27,12,3,12,12,36,3,44,81,10,19,34,62,13,18,138
Oklahoma City,35,"January 2, 2017",Milwaukee,0,0,94,98,1,48,94,40,20,7,5,10,20,32,8,36,78,9,27,27,51,13,19,108
Sacramento,35,"January 4, 2017",Miami,1,0,102,107,1,48,102,26,26,8,3,16,28,22,4,40,78,8,20,32,58,14,17,108
Miami,35,"January 1, 2017",Detroit,1,0,98,107,1,48,98,34,25,6,4,10,22,31,3,35,77,14,26,21,51,14,18,111
Memphis,35,"December 29, 2016",Oklahoma City,1,1,114,80,1,48,114,39,24,8,9,12,27,28,11,43,82,13,22,30,60,15,20,138
New Orleans,35,"December 30, 2016",New York,1,1,104,92,1,48,104,42,22,4,5,13,12,40,2,38,85,12,29,26,56,16,17,116
Boston,35,"January 3, 2017",Utah,1,1,115,104,1,48,115,32,31,5,6,13,22,28,4,41,74,17,31,24,43,16,17,142
Utah,35,"January 2, 2017",Brooklyn,0,1,101,89,1,48,101,46,11,9,5,9,19,34,12,39,93,7,24,32,69,16,20,105
Golden State,35,"January 2, 2017",Denver,1,1,127,119,1,48,127,43,33,7,2,13,14,31,12,50,95,11,25,39,70,16,21,149
Brooklyn,35,"January 6, 2017",Cleveland,1,0,108,116,1,48,108,52,21,6,1,19,34,42,10,41,91,9,30,32,61,17,19,117
Minnesota,35,"January 3, 2017",Philadelphia,0,0,91,93,1,48,91,47,20,7,6,17,24,38,9,33,82,7,24,26,58,18,20,103
Portland,35,"December 30, 2016",San Antonio,0,0,94,110,1,48,94,25,19,10,3,11,23,23,2,35,77,6,20,29,57,18,21,95
Phoenix,35,"January 2, 2017",L.A.Clippers,0,0,98,109,1,48,98,47,22,12,3,12,29,28,19,39,102,2,15,37,87,18,22,103
L.A. Lakers,35,"December 27, 2016",Utah,1,0,100,102,1,48,100,40,19,8,3,14,21,25,15,39,83,4,16,35,67,18,22,108
Detroit,35,"December 30, 2016",Atlanta,0,0,98,105,1,48,98,43,22,9,8,18,24,29,14,35,84,9,31,26,53,19,21,111
Charlotte,35,"January 2, 2017",Chicago,0,0,111,118,1,48,111,35,24,6,3,14,19,28,7,41,83,9,19,32,64,20,22,121
Toronto,35,"January 5, 2017",Utah,1,1,101,93,1,48,101,45,14,10,6,4,19,24,21,36,91,8,21,28,70,21,28,110
Milwaukee,35,"January 6, 2017",New York,1,0,111,116,1,48,111,35,24,9,10,14,19,29,6,39,78,12,22,27,56,21,28,129
Indiana,35,"January 1, 2017",Orlando,1,1,117,104,1,48,117,46,28,5,5,11,16,38,8,43,86,9,22,34,64,22,24,145
Dallas,35,"January 3, 2017",Washington,1,1,113,105,1,48,113,44,20,4,3,12,21,41,3,37,78,17,32,20,46,22,24,129
Philadelphia,35,"January 8, 2017",Brooklyn,0,1,105,95,1,48,105,46,19,11,5,13,17,40,6,37,94,8,27,29,67,23,27,112
Houston,35,"December 31, 2016",New York,1,1,129,122,1,48,129,46,30,3,2,13,20,36,10,42,92,21,55,21,37,24,29,142
Chicago,35,"January 2, 2017",Charlotte,1,1,118,111,1,48,118,44,23,10,9,9,17,30,14,42,90,7,23,35,67,27,29,145
Cleveland,35,"January 6, 2017",Brooklyn,0,1,116,108,1,48,116,46,19,14,3,12,16,41,5,38,88,9,33,29,55,31,43,124
Memphis,36,"December 31, 2016",Sacramento,0,1,112,98,1,48,112,40,25,6,3,7,20,28,12,44,87,17,35,27,52,7,9,134
New Orleans,36,"January 2, 2017",Cleveland,0,0,82,90,1,48,82,45,26,6,6,13,18,37,8,32,88,11,26,21,62,7,10,93
Orlando,36,"January 2, 2017",New York,0,1,115,103,1,48,115,39,35,10,4,12,20,26,13,45,91,15,31,30,60,10,14,141
Chicago,36,"January 4, 2017",Cleveland,0,1,106,94,1,48,106,43,23,8,4,12,18,31,12,41,85,13,30,28,55,11,15,124
Miami,36,"January 3, 2017",Phoenix,0,0,90,99,1,48,90,43,18,8,4,12,23,28,15,36,91,6,23,30,68,12,16,92
Brooklyn,36,"January 8, 2017",Philadelphia,1,0,95,105,1,48,95,40,21,6,8,22,23,36,4,36,78,10,27,26,51,13,17,102
San Antonio,36,"January 5, 2017",Denver,0,1,127,99,1,48,127,41,34,5,8,7,15,34,7,51,90,12,24,39,66,13,17,165
Minnesota,36,"January 6, 2017",Washington,0,0,105,112,1,48,105,38,22,6,2,10,15,26,12,42,88,7,18,35,70,14,17,114
Denver,36,"January 5, 2017",San Antonio,1,0,99,127,1,48,99,38,25,7,3,13,17,27,11,39,86,7,25,32,61,14,17,109
Atlanta,36,"January 5, 2017",New Orleans,0,1,99,94,1,48,99,55,23,9,6,14,14,43,12,38,90,9,23,29,67,14,17,123
Dallas,36,"January 5, 2017",Phoenix,1,0,95,102,1,48,95,31,18,6,7,10,20,24,7,36,79,9,29,27,50,14,17,101
Detroit,36,"January 1, 2017",Miami,0,1,107,98,1,48,107,48,16,7,5,12,18,38,10,42,86,9,22,33,64,14,22,119
Washington,36,"January 8, 2017",Milwaukee,0,1,107,101,1,48,107,49,23,10,4,19,22,36,13,41,84,10,32,31,52,15,18,128
Houston,36,"January 2, 2017",Washington,1,1,101,91,1,48,101,41,25,9,9,13,12,34,7,37,86,12,39,25,47,15,21,117
Cleveland,36,"January 8, 2017",Phoenix,0,1,120,116,1,48,120,38,15,8,5,20,12,25,13,44,82,15,34,29,48,17,19,126
Philadelphia,36,"January 11, 2017",New York,1,1,98,97,1,48,98,47,27,7,1,14,12,29,18,37,95,7,28,30,67,17,21,104
Utah,36,"January 3, 2017",Boston,0,0,104,115,1,48,104,35,27,7,3,10,17,27,8,38,82,11,26,27,56,17,21,118
Sacramento,36,"January 6, 2017",L.A.Clippers,1,0,98,106,1,48,98,50,23,4,3,6,18,38,12,36,87,9,30,27,57,17,22,116
Portland,36,"January 1, 2017",Minnesota,0,1,95,89,1,48,95,41,13,10,8,14,19,37,4,36,73,6,22,30,51,17,28,105
Milwaukee,36,"January 8, 2017",Washington,1,0,101,107,1,48,101,32,25,14,3,16,20,27,5,37,80,9,23,28,57,18,20,114
L.A. Clippers,36,"December 31, 2016",Oklahoma City,0,0,88,114,1,48,88,38,14,4,4,15,25,31,7,31,75,8,30,23,45,18,21,86
Phoenix,36,"January 3, 2017",Miami,1,1,99,90,1,48,99,49,21,7,7,18,23,36,13,36,77,9,23,27,54,18,22,120
L.A. Lakers,36,"December 29, 2016",Dallas,1,0,89,101,1,48,89,34,15,8,1,15,18,27,7,32,68,7,19,25,49,18,25,89
Oklahoma City,36,"January 4, 2017",Charlotte,0,0,112,123,1,48,112,51,22,6,3,14,31,37,14,42,96,9,30,33,66,19,23,122
Boston,36,"January 6, 2017",Philadelphia,1,1,110,106,1,48,110,42,28,6,11,17,22,30,12,35,87,19,40,16,47,21,25,124
New York,36,"January 6, 2017",Milwaukee,0,1,116,111,1,48,116,40,29,5,6,14,21,29,11,41,83,13,23,28,60,21,27,134
Golden State,36,"January 4, 2017",Portland,1,1,125,117,1,48,125,39,31,14,9,15,20,31,8,44,87,13,36,31,51,24,29,155
Indiana,36,"January 3, 2017",Detroit,0,1,121,116,1,48,121,34,26,7,7,11,8,28,6,43,74,9,16,34,58,26,30,149
Toronto,36,"January 7, 2017",Chicago,0,0,118,123,1,53,118,41,20,11,5,10,22,35,6,37,85,8,31,29,54,36,43,130
Charlotte,36,"January 4, 2017",Oklahoma City,1,1,123,112,1,48,123,43,25,8,11,11,21,33,10,37,80,9,24,28,56,40,49,147
Washington,37,"January 10, 2017",Chicago,1,1,101,99,1,48,101,42,24,8,6,21,24,35,7,42,83,11,22,31,61,6,9,116
Dallas,37,"January 7, 2017",Atlanta,1,0,82,97,1,48,82,41,18,7,3,14,25,35,6,32,82,9,36,23,46,9,10,86
Orlando,37,"January 4, 2017",Atlanta,1,0,92,111,1,48,92,40,19,9,6,17,17,30,10,37,86,9,28,28,58,9,10,99
Detroit,37,"January 3, 2017",Indiana,1,0,116,121,1,48,116,42,31,5,5,10,19,26,16,48,97,10,29,38,68,10,12,138
Milwaukee,37,"January 10, 2017",San Antonio,0,1,109,107,1,48,109,38,32,8,6,12,18,27,11,44,84,10,19,34,65,11,13,139
New Orleans,37,"January 5, 2017",Atlanta,1,0,94,99,1,48,94,52,19,8,4,15,18,37,15,34,93,15,35,19,58,11,14,100
Indiana,37,"January 5, 2017",Brooklyn,1,1,121,109,1,48,121,44,23,7,9,6,12,37,7,48,93,10,22,38,71,15,19,149
Minnesota,37,"January 7, 2017",Utah,1,0,92,94,1,48,92,48,23,3,3,15,21,34,14,35,80,7,20,28,60,15,21,103
Philadelphia,37,"January 13, 2017",Charlotte,1,1,102,93,1,48,102,38,26,12,9,20,27,28,10,36,76,14,38,22,38,16,20,123
San Antonio,37,"January 7, 2017",Charlotte,1,1,102,85,1,48,102,43,29,9,8,7,21,34,9,36,89,13,34,23,55,17,20,128
Brooklyn,37,"January 10, 2017",Atlanta,1,0,97,117,1,48,97,48,22,5,4,17,24,34,14,35,87,10,29,25,58,17,23,101
Denver,37,"January 7, 2017",Oklahoma City,0,0,106,121,1,48,106,53,18,7,4,12,23,38,15,40,99,9,24,31,75,17,24,110
New York,37,"January 7, 2017",Indiana,0,0,109,123,1,48,109,32,25,9,7,17,24,26,6,40,87,12,31,28,56,17,24,111
Utah,37,"January 5, 2017",Toronto,0,0,93,101,1,48,93,46,16,2,4,18,22,34,12,34,73,7,20,27,53,18,21,101
Boston,37,"January 7, 2017",New Orleans,1,1,117,108,1,48,117,47,26,6,5,10,22,32,15,40,93,18,36,22,57,19,21,136
Phoenix,37,"January 5, 2017",Dallas,0,1,102,95,1,48,102,53,15,4,3,15,21,35,18,38,85,7,17,31,68,19,22,112
Cleveland,37,"January 10, 2017",Utah,0,0,92,100,1,48,92,42,15,6,2,16,19,29,13,31,85,9,31,22,54,21,25,83
Houston,37,"January 5, 2017",Oklahoma City,1,1,118,116,1,48,118,43,27,6,3,9,20,34,9,41,86,15,39,26,47,21,30,134
Oklahoma City,37,"January 5, 2017",Houston,0,0,116,118,1,48,116,54,15,6,9,9,21,38,16,41,91,12,30,29,61,22,27,136
Sacramento,37,"January 8, 2017",Golden State,1,0,106,117,1,48,106,31,21,13,5,18,17,30,1,36,74,11,28,25,46,23,29,114
Portland,37,"January 4, 2017",Golden State,0,0,117,125,1,48,117,44,23,8,5,17,26,33,11,40,89,12,26,28,63,25,28,128
Miami,37,"January 4, 2017",Sacramento,0,1,107,102,1,48,107,39,24,8,9,18,20,32,7,35,72,12,28,23,44,25,29,128
L.A. Lakers,37,"January 1, 2017",Toronto,1,0,114,123,1,48,114,43,19,8,3,7,21,27,16,37,92,15,32,22,60,25,31,119
Atlanta,37,"January 7, 2017",Dallas,0,1,97,82,1,48,97,47,19,8,1,10,15,41,6,30,74,11,22,19,52,26,32,112
Toronto,37,"January 8, 2017",Houston,1,0,122,129,1,48,122,39,19,7,3,17,25,35,4,42,78,11,25,31,53,27,30,134
L.A. Clippers,37,"January 2, 2017",Phoenix,1,1,109,98,1,48,109,51,17,1,11,20,21,39,12,37,79,7,16,30,63,28,38,117
Golden State,37,"January 6, 2017",Memphis,1,0,119,128,1,53,119,44,23,7,5,16,21,37,7,41,83,8,30,33,53,29,39,130
Charlotte,37,"January 5, 2017",Detroit,0,0,114,115,1,48,114,49,20,4,5,5,23,41,8,37,91,10,26,27,65,30,34,129
Memphis,37,"January 3, 2017",L.A.Lakers,0,0,102,116,1,48,102,39,18,6,1,10,16,34,5,30,77,10,31,20,46,32,35,106
Chicago,37,"January 7, 2017",Toronto,1,1,123,118,1,53,123,60,25,5,2,14,27,43,17,38,97,11,28,27,69,36,39,139
Brooklyn,38,"January 12, 2017",New Orleans,1,0,95,104,1,48,95,50,22,10,6,16,20,43,7,40,97,9,42,31,55,6,11,105
Dallas,38,"January 9, 2017",Minnesota,0,0,92,101,1,48,92,25,24,3,2,14,21,20,5,36,78,13,28,23,50,7,9,88
Houston,38,"January 6, 2017",Orlando,0,1,100,93,1,48,100,45,26,12,1,15,15,33,12,39,86,15,49,24,37,7,12,117
Washington,38,"January 11, 2017",Boston,0,0,108,117,1,48,108,44,28,10,3,7,13,28,16,45,105,10,26,35,79,8,12,122
Orlando,38,"January 6, 2017",Houston,1,0,93,100,1,48,93,49,18,8,2,15,14,30,19,38,91,8,23,30,68,9,13,98
San Antonio,38,"January 10, 2017",Milwaukee,1,0,107,109,1,48,107,41,22,5,7,14,10,28,13,42,88,12,30,30,58,11,14,119
Philadelphia,38,"January 14, 2017",Washington,0,0,93,109,1,48,93,49,20,6,2,16,19,34,15,36,87,10,31,26,56,11,21,93
New York,38,"January 9, 2017",New Orleans,1,0,96,110,1,48,96,45,17,5,4,14,18,33,12,36,85,11,29,25,56,13,16,101
Phoenix,38,"January 8, 2017",Cleveland,1,0,116,120,1,48,116,36,23,12,7,14,19,23,13,46,87,9,27,37,60,15,19,135
Minnesota,38,"January 9, 2017",Dallas,1,1,101,92,1,48,101,42,30,11,4,18,24,33,9,40,71,6,16,34,55,15,21,133
L.A. Lakers,38,"January 3, 2017",Memphis,1,1,116,102,1,48,116,43,34,5,2,9,23,34,9,42,82,17,33,25,49,15,28,138
Miami,38,"January 6, 2017",L.A.Lakers,0,0,100,127,1,48,100,41,17,5,7,10,23,30,11,38,92,8,32,30,60,16,27,95
Boston,38,"January 10, 2017",Toronto,0,0,106,114,1,48,106,33,21,7,3,14,20,27,6,40,85,9,27,31,58,17,20,108
Golden State,38,"January 8, 2017",Sacramento,0,1,117,106,1,48,117,46,33,11,6,17,22,33,13,45,89,10,29,35,60,17,20,149
New Orleans,38,"January 7, 2017",Boston,0,0,108,117,1,48,108,42,22,7,7,11,20,33,9,40,85,10,31,30,54,18,23,125
Chicago,38,"January 9, 2017",Oklahoma City,1,0,94,109,1,48,94,38,18,7,3,11,13,29,9,34,84,7,20,27,64,19,22,96
Memphis,38,"January 4, 2017",L.A.Clippers,0,0,106,115,1,48,106,43,30,6,5,9,31,31,12,38,88,11,28,27,60,19,25,125
Portland,38,"January 5, 2017",L.A.Lakers,1,1,118,109,1,48,118,47,29,6,5,13,21,39,8,43,81,12,33,31,48,20,30,144
Denver,38,"January 12, 2017",Indiana,1,1,140,112,1,48,140,48,37,10,5,15,16,35,13,52,91,15,32,37,59,21,23,184
Charlotte,38,"January 7, 2017",San Antonio,0,0,85,102,1,48,85,48,18,5,4,15,14,40,8,30,75,4,21,26,54,21,25,96
Cleveland,38,"January 11, 2017",Portland,0,0,86,102,1,48,86,48,14,5,4,15,20,35,13,28,82,9,30,19,52,21,28,81
Toronto,38,"January 10, 2017",Boston,1,1,114,106,1,48,114,50,17,9,7,17,21,33,17,41,87,10,22,31,65,22,27,129
Utah,38,"January 7, 2017",Minnesota,0,1,94,92,1,48,94,39,23,12,6,8,19,29,10,32,77,8,23,24,54,22,28,115
Atlanta,38,"January 10, 2017",Brooklyn,0,1,117,97,1,48,117,53,25,11,12,12,17,38,15,44,92,7,23,37,69,22,38,142
Oklahoma City,38,"January 7, 2017",Denver,1,1,121,106,1,48,121,49,23,8,11,10,20,43,6,43,89,12,36,31,53,23,29,150
Sacramento,38,"January 10, 2017",Detroit,1,1,100,94,1,48,100,46,21,6,3,16,17,34,12,32,74,13,24,19,50,23,29,112
Indiana,38,"January 7, 2017",New York,1,1,123,109,1,48,123,53,25,11,0,19,23,41,12,43,86,11,24,32,62,26,28,148
Milwaukee,38,"January 13, 2017",Miami,1,1,116,108,1,48,116,46,28,8,6,11,18,33,13,40,80,9,15,31,65,27,31,149
Detroit,38,"January 5, 2017",Charlotte,1,1,115,114,1,48,115,57,24,2,6,7,23,41,16,39,97,10,28,29,69,27,32,134
L.A. Clippers,38,"January 4, 2017",Memphis,1,1,115,106,1,48,115,45,23,5,5,13,23,37,8,37,73,9,23,28,50,32,45,131
Charlotte,39,"January 10, 2017",Houston,0,0,114,121,1,48,114,43,30,3,4,11,21,38,5,44,92,19,43,25,49,7,9,133
Portland,39,"January 8, 2017",Detroit,1,0,124,125,1,58,124,42,36,5,6,16,11,35,7,51,98,15,35,36,63,7,12,145
Oklahoma City,39,"January 9, 2017",Chicago,0,1,109,94,1,48,109,42,30,5,5,12,17,36,6,47,83,7,24,40,59,8,11,140
New York,39,"January 11, 2017",Philadelphia,0,0,97,98,1,48,97,41,20,7,7,13,22,33,8,42,86,4,22,38,64,9,10,114
Detroit,39,"January 8, 2017",Portland,0,1,125,124,1,58,125,41,19,14,3,9,16,35,6,54,105,8,25,46,80,9,12,139
Indiana,39,"January 12, 2017",Denver,0,0,112,140,1,48,112,34,26,9,4,16,15,22,12,44,94,12,29,32,65,12,13,118
Denver,39,"January 16, 2017",Orlando,1,1,125,112,1,48,125,39,33,11,2,14,17,30,9,52,89,9,27,43,62,12,15,156
Dallas,39,"January 12, 2017",Phoenix,0,1,113,108,1,48,113,32,29,11,8,9,20,24,8,43,89,15,34,28,55,12,17,133
Washington,39,"January 14, 2017",Philadelphia,1,1,109,93,1,48,109,50,18,9,2,11,18,38,12,44,91,8,17,36,74,13,18,125
Milwaukee,39,"January 15, 2017",Atlanta,0,0,98,111,1,48,98,36,25,11,5,16,25,23,13,39,79,6,19,33,60,14,18,115
Boston,39,"January 11, 2017",Washington,1,1,117,108,1,48,117,45,20,5,7,14,10,35,10,43,85,17,41,26,44,14,18,134
Utah,39,"January 8, 2017",Memphis,0,0,79,88,1,48,79,44,14,8,3,18,19,33,11,28,72,9,23,19,49,14,23,77
Sacramento,39,"January 13, 2017",Cleveland,1,0,108,120,1,48,108,42,23,7,5,21,22,31,11,42,80,9,25,33,55,15,19,122
Memphis,39,"January 6, 2017",Golden State,0,1,128,119,1,53,128,47,29,13,0,12,28,33,14,50,103,13,33,37,70,15,19,148
L.A. Clippers,39,"January 6, 2017",Sacramento,0,1,106,98,1,48,106,45,28,6,5,8,13,37,8,39,84,13,31,26,53,15,21,131
New Orleans,39,"January 9, 2017",New York,0,1,110,96,1,48,110,40,24,11,7,8,14,31,9,41,85,12,27,29,58,16,19,137
Brooklyn,39,"January 13, 2017",Toronto,0,0,113,132,1,48,113,35,26,5,1,11,16,31,4,40,86,17,36,23,50,16,20,119
Miami,39,"January 8, 2017",L.A.Clippers,0,0,86,98,1,48,86,50,14,6,5,15,21,39,11,31,84,7,27,24,57,17,21,89
Toronto,39,"January 13, 2017",Brooklyn,1,1,132,113,1,48,132,49,21,7,9,8,17,36,13,52,97,11,28,41,69,17,21,161
Cleveland,39,"January 13, 2017",Sacramento,0,1,120,108,1,48,120,39,27,11,3,12,20,29,10,44,87,15,37,29,50,17,22,140
Atlanta,39,"January 13, 2017",Boston,1,0,101,103,1,48,101,43,22,5,5,12,17,31,12,36,83,11,29,25,54,18,21,114
Golden State,39,"January 10, 2017",Miami,1,1,107,95,1,48,107,48,28,6,7,11,16,43,5,39,86,11,27,28,59,18,22,134
Chicago,39,"January 10, 2017",Washington,0,0,99,101,1,48,99,44,19,10,2,17,18,32,12,35,88,10,27,25,61,19,21,102
Orlando,39,"January 8, 2017",L.A.Lakers,0,0,95,111,1,48,95,54,24,5,3,18,20,36,18,34,90,7,26,27,64,20,29,98
Phoenix,39,"January 12, 2017",Dallas,1,0,108,113,1,48,108,47,15,2,4,19,23,34,13,38,78,10,18,28,60,22,27,112
Minnesota,39,"January 11, 2017",Houston,1,1,119,105,1,48,119,49,31,8,8,17,19,40,9,44,81,8,23,36,58,23,25,159
San Antonio,39,"January 12, 2017",L.A.Lakers,1,1,134,94,1,48,134,46,32,5,5,12,20,39,7,49,81,10,21,39,60,26,29,175
Houston,39,"January 8, 2017",Toronto,0,1,129,122,1,48,129,39,27,9,6,15,22,29,10,46,89,11,38,35,51,26,31,147
L.A. Lakers,39,"January 5, 2017",Portland,0,0,109,118,1,48,109,40,15,7,3,11,25,30,10,36,86,10,31,26,55,27,33,107
Philadelphia,39,"January 16, 2017",Milwaukee,0,1,113,104,1,48,113,51,25,8,9,18,23,38,13,35,78,14,37,21,41,29,36,138
New York,40,"January 12, 2017",Chicago,1,1,104,89,1,48,104,47,21,4,6,12,17,30,17,44,92,7,23,37,69,9,11,120
Detroit,40,"January 10, 2017",Sacramento,0,0,94,100,1,48,94,35,14,12,9,12,24,27,8,36,82,12,27,24,55,10,16,100
Memphis,40,"January 8, 2017",Utah,1,1,88,79,1,48,88,37,19,11,3,13,23,32,5,34,78,9,24,25,54,11,14,98
Indiana,40,"January 16, 2017",New Orleans,1,1,98,95,1,48,98,46,26,10,7,16,18,41,5,41,81,5,19,36,62,11,16,126
Utah,40,"January 10, 2017",Cleveland,1,1,100,92,1,48,100,46,22,8,4,18,21,35,11,38,79,13,34,25,45,11,19,113
Orlando,40,"January 11, 2017",L.A.Clippers,0,0,96,105,1,48,96,35,21,8,3,13,21,29,6,39,92,6,27,33,65,12,18,91
Golden State,40,"January 12, 2017",Detroit,1,1,127,107,1,48,127,37,39,14,4,18,14,31,6,50,89,15,29,35,60,12,18,158
Minnesota,40,"January 13, 2017",Oklahoma City,1,1,96,86,1,48,96,42,21,11,6,15,22,33,9,39,86,5,18,34,68,13,14,113
Miami,40,"January 10, 2017",Golden State,0,0,95,107,1,48,95,45,25,6,4,11,22,40,5,38,89,6,30,32,59,13,17,109
Atlanta,40,"January 15, 2017",Milwaukee,1,1,111,98,1,48,111,37,29,9,4,19,20,23,14,42,80,13,26,29,54,14,18,129
Dallas,40,"January 15, 2017",Minnesota,1,1,98,87,1,48,98,41,21,8,8,11,18,35,6,36,77,12,29,24,48,14,19,119
Boston,40,"January 13, 2017",Atlanta,0,1,103,101,1,48,103,43,22,7,2,12,16,34,9,36,83,17,44,19,39,14,19,113
Brooklyn,40,"January 15, 2017",Houston,1,0,112,137,1,48,112,38,29,9,4,16,25,29,9,41,93,15,44,26,49,15,19,120
Portland,40,"January 10, 2017",L.A.Lakers,0,1,108,87,1,48,108,50,25,6,9,11,21,41,9,43,85,7,21,36,64,15,20,140
Milwaukee,40,"January 16, 2017",Philadelphia,1,0,104,113,1,48,104,38,23,8,6,12,23,28,10,42,89,5,14,37,75,15,22,113
Chicago,40,"January 12, 2017",New York,0,0,89,104,1,48,89,43,20,5,4,13,12,29,14,35,88,3,18,32,70,16,21,90
Denver,40,"January 17, 2017",L.A.Lakers,0,1,127,121,1,48,127,45,29,5,10,17,17,32,13,50,88,11,26,39,62,16,26,151
New Orleans,40,"January 12, 2017",Brooklyn,0,1,104,95,1,48,104,50,16,12,4,16,16,41,9,38,90,11,32,27,58,17,25,110
L.A. Clippers,40,"January 8, 2017",Miami,1,1,98,86,1,48,98,51,27,8,3,11,20,42,9,36,86,9,30,27,56,17,25,118
Toronto,40,"January 15, 2017",New York,1,1,116,101,1,48,116,42,21,9,4,10,20,32,10,44,89,8,22,36,67,20,23,134
Cleveland,40,"January 16, 2017",Golden State,0,0,91,126,1,48,91,35,11,7,4,15,21,28,7,31,88,9,34,22,54,20,27,69
L.A. Lakers,40,"January 6, 2017",Miami,1,1,127,100,1,48,127,62,22,6,2,11,22,44,18,48,96,10,28,38,68,21,29,152
Phoenix,40,"January 14, 2017",San Antonio,1,1,108,105,1,48,108,45,18,10,0,15,30,30,15,39,85,8,21,31,64,22,24,118
Washington,40,"January 16, 2017",Portland,1,1,120,101,1,48,120,51,26,10,5,12,18,39,12,42,86,13,23,29,63,23,25,154
Oklahoma City,40,"January 11, 2017",Memphis,1,1,103,95,1,48,103,53,21,5,4,16,18,42,11,36,80,8,26,28,54,23,29,120
Philadelphia,40,"January 18, 2017",Toronto,1,1,94,89,1,48,94,48,20,5,7,22,21,42,6,31,70,8,24,23,46,24,32,105
Houston,40,"January 10, 2017",Charlotte,1,1,121,114,1,48,121,44,25,8,5,10,17,38,6,40,82,17,39,23,43,24,33,142
San Antonio,40,"January 14, 2017",Phoenix,0,0,105,108,1,48,105,33,15,8,1,16,18,27,6,36,71,9,20,27,51,24,34,101
Charlotte,40,"January 13, 2017",Philadelphia,0,0,93,102,1,48,93,41,11,12,2,19,19,25,16,28,85,6,23,22,62,31,32,82
Sacramento,40,"January 15, 2017",Oklahoma City,1,0,118,122,1,48,118,44,24,13,6,22,29,30,14,37,81,9,24,28,57,35,40,134
Utah,41,"January 13, 2017",Detroit,1,1,110,77,1,48,110,48,22,10,6,12,14,41,7,43,80,16,31,27,49,8,13,142
Boston,41,"January 16, 2017",Charlotte,1,1,108,98,1,48,108,44,29,6,3,12,11,36,8,42,84,15,39,27,45,9,10,135
Philadelphia,41,"January 20, 2017",Portland,1,1,93,92,1,48,93,53,25,6,8,19,21,40,13,36,92,12,29,24,63,9,16,103
Milwaukee,41,"January 18, 2017",Houston,0,0,92,111,1,48,92,50,26,8,8,18,14,35,15,37,93,7,28,30,65,11,14,107
Portland,41,"January 11, 2017",Cleveland,1,1,102,86,1,48,102,51,29,6,9,9,17,38,13,40,93,10,30,30,63,12,16,131
Minnesota,41,"January 15, 2017",Dallas,0,0,87,98,1,48,87,44,20,7,1,12,16,34,10,35,80,5,21,30,59,12,18,96
Memphis,41,"January 11, 2017",Oklahoma City,0,0,95,103,1,48,95,39,18,11,4,10,26,26,13,38,92,7,24,31,68,12,21,94
Toronto,41,"January 17, 2017",Brooklyn,0,1,119,109,1,48,119,44,18,8,6,9,19,34,10,48,92,10,19,38,73,13,16,139
Cleveland,41,"January 19, 2017",Phoenix,1,1,118,103,1,48,118,36,29,7,6,12,24,32,4,43,85,19,43,24,42,13,19,136
Chicago,41,"January 14, 2017",New Orleans,1,1,107,99,1,48,107,63,22,10,6,10,20,42,21,43,101,8,20,35,81,13,23,130
Charlotte,41,"January 16, 2017",Boston,0,0,98,108,1,48,98,42,25,4,4,11,15,32,10,38,86,8,25,30,61,14,17,111
Miami,41,"January 13, 2017",Milwaukee,0,0,108,116,1,48,108,27,33,6,8,8,21,23,4,41,83,12,32,29,51,14,18,128
Dallas,41,"January 17, 2017",Chicago,0,1,99,98,1,48,99,36,27,5,2,12,21,30,6,37,78,11,28,26,50,14,18,112
New Orleans,41,"January 14, 2017",Chicago,0,0,99,107,1,48,99,42,27,3,6,11,19,36,6,39,84,7,23,32,61,14,21,114
Detroit,41,"January 12, 2017",Golden State,0,0,107,127,1,48,107,40,20,10,4,19,19,31,9,43,88,6,28,37,60,15,20,112
Phoenix,41,"January 16, 2017",Utah,1,0,101,106,1,48,101,39,13,4,5,9,21,33,6,40,81,5,22,35,59,16,17,111
Atlanta,41,"January 16, 2017",New York,0,1,108,107,1,48,108,36,26,11,3,10,15,28,8,40,87,12,32,28,55,16,23,120
Oklahoma City,41,"January 13, 2017",Minnesota,0,0,86,96,1,48,86,47,19,10,2,18,21,31,16,33,85,3,20,30,65,17,21,90
Houston,41,"January 11, 2017",Minnesota,0,0,105,119,1,48,105,32,23,7,4,15,23,25,7,36,87,15,42,21,45,18,22,101
L.A. Clippers,41,"January 11, 2017",Orlando,1,1,105,96,1,48,105,49,23,11,5,21,20,40,9,39,76,9,26,30,50,18,26,127
L.A. Lakers,41,"January 8, 2017",Orlando,1,1,111,95,1,48,111,47,23,8,5,13,21,41,6,42,87,8,32,34,55,19,24,131
Golden State,41,"January 16, 2017",Cleveland,1,1,126,91,1,48,126,58,37,10,11,16,22,47,11,46,91,15,34,31,57,19,24,176
New York,41,"January 15, 2017",Toronto,0,0,101,116,1,48,101,41,21,7,7,14,16,30,11,35,84,12,29,23,55,19,27,106
Denver,41,"January 19, 2017",San Antonio,0,0,104,118,1,48,104,43,27,5,7,15,19,32,11,37,91,10,31,27,60,20,26,111
Indiana,41,"January 18, 2017",Sacramento,0,1,106,100,1,48,106,32,22,11,3,14,21,24,8,39,75,7,21,32,54,21,25,120
Sacramento,41,"January 18, 2017",Indiana,1,0,100,106,1,48,100,36,28,9,5,21,22,26,10,35,72,9,21,26,51,21,27,114
Brooklyn,41,"January 17, 2017",Toronto,1,0,109,119,1,48,109,41,20,7,6,13,19,30,11,40,89,7,26,33,63,22,24,119
Orlando,41,"January 13, 2017",Portland,0,1,115,109,1,48,115,45,21,5,5,15,19,36,9,41,83,10,18,31,65,23,26,131
Washington,41,"January 18, 2017",Memphis,1,1,104,101,1,48,104,45,27,7,3,11,25,33,12,36,80,8,29,28,51,24,26,129
San Antonio,41,"January 17, 2017",Minnesota,1,1,122,114,1,48,122,34,27,9,3,7,29,28,6,43,84,8,18,35,66,28,35,140
L.A. Clippers,42,"January 14, 2017",L.A.Lakers,1,1,113,97,1,48,113,42,28,6,6,7,24,35,7,48,92,10,28,38,64,7,8,143
Dallas,42,"January 19, 2017",Miami,0,0,95,99,1,48,95,33,17,4,3,9,20,28,5,37,82,14,36,23,46,7,11,94
Detroit,42,"January 13, 2017",Utah,0,0,77,110,1,48,77,35,15,5,4,13,16,32,3,30,76,6,17,24,59,11,16,72
Washington,42,"January 19, 2017",New York,0,1,113,110,1,48,113,40,29,7,5,15,19,30,10,44,88,13,32,31,56,12,14,133
Cleveland,42,"January 21, 2017",San Antonio,1,0,115,118,1,53,115,47,25,7,1,18,16,36,11,45,91,13,34,32,57,12,22,121
New Orleans,42,"January 16, 2017",Indiana,0,0,95,98,1,48,95,38,18,7,6,13,17,30,8,36,84,10,25,26,59,13,18,98
Charlotte,42,"January 18, 2017",Portland,1,1,107,85,1,48,107,51,28,11,8,12,13,43,8,41,87,11,26,30,61,14,17,144
L.A. Lakers,42,"January 10, 2017",Portland,1,0,87,108,1,48,87,38,18,7,5,10,18,29,9,32,83,9,24,23,59,14,26,82
Philadelphia,42,"January 21, 2017",Atlanta,0,0,93,110,1,48,93,38,27,8,6,21,19,32,6,33,78,12,29,21,49,15,18,103
Toronto,42,"January 18, 2017",Philadelphia,0,0,89,94,1,48,89,43,17,10,3,9,24,31,12,34,86,6,24,28,62,15,23,93
New York,42,"January 16, 2017",Atlanta,1,0,107,108,1,48,107,53,21,8,3,18,22,38,15,42,85,8,26,34,59,15,23,123
Miami,42,"January 17, 2017",Houston,1,1,109,103,1,48,109,52,21,11,1,15,24,41,11,42,90,9,29,33,61,16,24,123
Indiana,42,"January 20, 2017",L.A.Lakers,0,0,96,108,1,48,96,37,24,17,7,20,12,29,8,34,80,10,24,24,56,18,25,108
Milwaukee,42,"January 20, 2017",Orlando,0,0,96,112,1,48,96,40,21,6,3,12,25,30,10,34,84,10,25,24,59,18,26,96
Memphis,42,"January 13, 2017",Houston,0,1,110,105,1,48,110,45,25,8,3,22,29,37,8,41,76,10,27,31,49,18,27,125
Orlando,42,"January 14, 2017",Utah,0,0,107,114,1,48,107,40,23,10,2,14,28,33,7,38,82,12,34,26,48,19,27,116
Golden State,42,"January 18, 2017",Oklahoma City,1,1,121,100,1,48,121,46,35,11,8,18,16,35,11,46,85,10,21,36,64,19,27,156
Portland,42,"January 13, 2017",Orlando,1,0,109,115,1,48,109,43,19,6,9,9,20,31,12,39,97,10,34,29,63,21,25,115
San Antonio,42,"January 19, 2017",Denver,1,1,118,104,1,48,118,43,28,12,5,7,19,37,6,44,86,9,22,35,64,21,25,153
Denver,42,"January 21, 2017",L.A.Clippers,1,1,123,98,1,48,123,46,30,4,0,10,16,35,11,46,87,10,24,36,63,21,26,147
Sacramento,42,"January 20, 2017",Memphis,0,0,91,107,1,48,91,35,18,9,6,10,21,30,5,31,76,6,29,25,47,23,32,95
Chicago,42,"January 15, 2017",Memphis,0,1,108,104,1,48,108,47,18,8,5,12,14,41,6,40,78,4,17,36,61,24,35,125
Phoenix,42,"January 19, 2017",Cleveland,0,0,103,118,1,48,103,46,23,10,4,14,22,31,15,37,85,4,19,33,66,25,31,118
Utah,42,"January 14, 2017",Orlando,1,1,114,107,1,48,114,45,28,6,2,13,20,36,9,41,83,7,26,34,57,25,36,129
Boston,42,"January 18, 2017",New York,1,0,106,117,1,48,106,33,25,8,8,3,15,24,9,35,91,9,33,26,58,27,29,119
Houston,42,"January 13, 2017",Memphis,1,0,105,110,1,48,105,31,19,9,2,12,20,21,10,33,82,10,41,23,41,29,36,98
Atlanta,42,"January 18, 2017",Detroit,0,0,95,118,1,48,95,32,22,1,4,12,21,24,8,30,78,6,25,24,53,29,37,86
Brooklyn,42,"January 20, 2017",New Orleans,0,1,143,114,1,48,143,52,24,5,6,16,20,43,9,48,83,15,30,33,53,32,35,176
Oklahoma City,42,"January 15, 2017",Sacramento,0,1,122,118,1,48,122,44,20,14,4,19,28,27,17,40,90,9,28,31,62,33,41,127
Minnesota,42,"January 17, 2017",San Antonio,0,0,114,122,1,48,114,39,26,5,6,18,22,33,6,36,73,6,13,30,60,36,41,130
New Orleans,43,"January 18, 2017",Orlando,1,1,118,98,1,48,118,44,28,11,5,8,13,39,5,46,93,15,36,31,57,11,15,147
Detroit,43,"January 15, 2017",L.A.Lakers,0,1,102,97,1,48,102,46,24,6,6,7,22,36,10,41,95,9,25,32,70,11,16,118
San Antonio,43,"January 21, 2017",Cleveland,0,1,118,115,1,53,118,46,32,6,6,13,22,36,10,48,96,10,26,38,70,12,14,145
Brooklyn,43,"January 21, 2017",Charlotte,0,0,105,112,1,48,105,40,30,9,3,11,17,36,4,38,89,17,41,21,48,12,15,122
Indiana,43,"January 21, 2017",Utah,0,0,100,109,1,48,100,36,17,10,3,16,23,32,4,39,77,10,20,29,57,12,17,107
Memphis,43,"January 15, 2017",Chicago,1,0,104,108,1,48,104,50,24,6,3,10,22,37,13,40,95,11,32,29,63,13,13,122
Toronto,43,"January 20, 2017",Charlotte,0,0,78,113,1,48,78,33,10,7,6,12,20,25,8,29,86,7,30,22,56,13,14,64
Orlando,43,"January 16, 2017",Denver,0,0,112,125,1,48,112,35,28,6,1,14,10,27,8,45,89,8,25,37,64,14,18,120
New York,43,"January 18, 2017",Boston,0,1,117,106,1,48,117,57,27,2,8,14,24,39,18,46,91,10,25,36,66,15,18,149
Atlanta,43,"January 20, 2017",Chicago,1,1,102,93,1,48,102,40,23,16,3,19,19,30,10,39,82,9,22,30,60,15,19,118
Oklahoma City,43,"January 16, 2017",L.A.Clippers,0,0,98,120,1,48,98,36,18,10,4,15,15,27,9,36,85,10,30,26,55,16,19,99
Sacramento,43,"January 21, 2017",Chicago,0,0,99,102,1,48,99,40,20,7,5,9,23,31,9,37,84,9,26,28,58,16,21,110
Golden State,43,"January 20, 2017",Houston,0,1,125,108,1,48,125,41,30,8,7,14,18,33,8,47,89,15,38,32,51,16,21,150
Utah,43,"January 16, 2017",Phoenix,0,1,106,101,1,48,106,46,22,4,6,8,16,32,14,41,89,8,23,33,66,16,24,120
Denver,43,"January 22, 2017",Minnesota,0,0,108,111,1,48,108,40,26,7,6,17,19,28,12,42,82,7,24,35,58,17,21,126
Chicago,43,"January 17, 2017",Dallas,1,0,98,99,1,48,98,43,23,6,4,13,22,32,11,37,82,6,14,31,68,18,22,112
L.A. Clippers,43,"January 16, 2017",Oklahoma City,1,1,120,98,1,48,120,47,27,9,5,15,15,37,10,45,82,12,28,33,54,18,22,152
L.A. Lakers,43,"January 12, 2017",San Antonio,0,0,94,134,1,48,94,29,23,6,3,9,25,20,9,35,85,6,19,29,66,18,25,89
Minnesota,43,"January 19, 2017",L.A.Clippers,0,1,104,101,1,48,104,43,25,3,2,13,21,30,13,40,84,5,16,35,68,19,25,114
Portland,43,"January 16, 2017",Washington,0,0,101,120,1,48,101,45,22,6,5,15,20,31,14,37,88,8,26,29,62,19,25,107
Miami,43,"January 19, 2017",Dallas,1,1,99,95,1,48,99,40,16,4,1,13,15,34,6,35,73,9,20,26,53,20,29,100
Philadelphia,43,"January 24, 2017",L.A.Clippers,1,1,121,110,1,48,121,38,35,8,7,5,27,32,6,45,90,10,29,35,61,21,22,158
Charlotte,43,"January 20, 2017",Toronto,1,1,113,78,1,48,113,51,24,9,4,14,13,40,11,40,80,12,25,28,55,21,25,143
Cleveland,43,"January 23, 2017",New Orleans,0,0,122,124,1,48,122,45,24,6,3,11,20,34,11,43,93,15,37,28,56,21,25,135
Dallas,43,"January 20, 2017",Utah,1,0,107,112,1,53,107,42,21,5,2,12,26,33,9,39,87,8,23,31,64,21,28,110
Phoenix,43,"January 21, 2017",New York,0,1,107,105,1,48,107,44,15,9,4,13,18,30,14,37,85,9,24,28,61,24,27,115
Houston,43,"January 15, 2017",Brooklyn,0,1,137,112,1,48,137,50,30,9,4,13,21,39,11,46,90,21,44,25,46,24,32,165
Milwaukee,43,"January 21, 2017",Miami,0,0,97,109,1,48,97,41,17,6,2,11,18,29,12,33,79,6,18,27,61,25,32,99
Boston,43,"January 21, 2017",Portland,1,0,123,127,1,53,123,47,26,6,2,21,29,33,14,42,92,13,35,29,57,26,31,128
Washington,43,"January 21, 2017",Detroit,0,0,112,113,1,48,112,47,23,12,3,11,22,34,13,39,91,8,26,31,65,26,33,127
Orlando,44,"January 18, 2017",New Orleans,0,0,98,118,1,48,98,48,18,6,5,18,14,43,5,39,88,11,32,28,56,9,11,106
Portland,44,"January 18, 2017",Charlotte,0,0,85,107,1,48,85,50,18,10,12,15,11,35,15,33,94,8,31,25,63,11,11,99
San Antonio,44,"January 23, 2017",Brooklyn,0,1,112,86,1,48,112,50,22,7,5,8,17,37,13,45,95,9,22,36,73,13,16,135
Washington,44,"January 23, 2017",Charlotte,0,1,109,99,1,48,109,47,22,5,3,14,23,42,5,43,80,10,25,33,55,13,17,131
Atlanta,44,"January 21, 2017",Philadelphia,1,1,110,93,1,48,110,48,24,7,5,13,18,37,11,45,91,7,20,38,71,13,23,125
L.A. Clippers,44,"January 19, 2017",Minnesota,1,0,101,104,1,48,101,41,24,9,6,11,21,27,14,42,87,4,22,38,65,13,24,114
Miami,44,"January 21, 2017",Milwaukee,1,1,109,97,1,48,109,39,18,8,3,11,24,34,5,41,77,13,30,28,47,14,22,122
Golden State,44,"January 22, 2017",Orlando,0,1,118,98,1,48,118,52,27,8,4,18,15,39,13,42,89,19,42,23,47,15,19,140
Minnesota,44,"January 22, 2017",Denver,1,1,111,108,1,48,111,36,29,11,8,15,24,28,8,45,84,6,15,39,69,15,21,135
L.A. Lakers,44,"January 14, 2017",L.A.Clippers,0,0,97,113,1,48,97,41,21,3,2,14,20,34,7,36,81,10,21,26,60,15,27,93
Oklahoma City,44,"January 18, 2017",Golden State,0,0,100,121,1,48,100,36,23,11,6,18,22,23,13,38,90,8,28,30,62,16,19,103
Brooklyn,44,"January 23, 2017",San Antonio,1,0,86,112,1,48,86,38,14,2,5,16,18,33,5,32,81,5,25,27,56,17,18,79
New Orleans,44,"January 20, 2017",Brooklyn,1,0,114,143,1,48,114,47,21,8,8,9,24,29,18,43,105,11,34,32,71,17,23,121
Cleveland,44,"January 25, 2017",Sacramento,1,0,112,116,1,53,112,47,29,9,6,18,21,34,13,40,82,15,38,25,44,17,34,126
Chicago,44,"January 20, 2017",Atlanta,0,0,93,102,1,48,93,41,18,12,5,24,17,29,12,34,81,7,28,27,53,18,19,97
Detroit,44,"January 18, 2017",Atlanta,1,1,118,95,1,48,118,60,27,6,0,12,29,42,18,45,91,10,25,35,66,18,28,143
Dallas,44,"January 22, 2017",L.A.Lakers,1,1,122,73,1,48,122,49,27,9,4,10,15,36,13,43,87,17,39,26,48,19,19,157
New York,44,"January 19, 2017",Washington,1,0,110,113,1,48,110,41,20,7,4,10,14,27,14,42,90,7,24,35,66,19,22,121
Charlotte,44,"January 21, 2017",Brooklyn,1,1,112,105,1,48,112,47,26,6,5,13,18,41,6,39,82,14,29,25,53,20,22,138
Indiana,44,"January 23, 2017",New York,1,0,103,109,1,48,103,38,18,7,4,11,20,30,8,38,86,7,26,31,60,20,25,106
Sacramento,44,"January 23, 2017",Detroit,0,1,109,104,1,48,109,44,25,9,3,14,15,34,10,40,82,9,21,31,61,20,26,128
Boston,44,"January 24, 2017",Washington,0,0,108,123,1,48,108,32,24,10,3,13,20,24,8,38,84,10,33,28,51,22,24,116
Philadelphia,44,"January 25, 2017",Milwaukee,0,1,114,109,1,48,114,43,32,9,4,21,21,34,9,40,75,12,26,28,49,22,25,143
Milwaukee,44,"January 23, 2017",Houston,1,1,127,114,1,48,127,37,31,17,6,19,20,30,7,47,80,11,23,36,57,22,27,161
Houston,44,"January 17, 2017",Miami,0,0,103,109,1,48,103,49,21,8,3,17,16,38,11,36,90,9,39,27,51,22,28,107
Denver,44,"January 24, 2017",Utah,1,1,103,93,1,48,103,43,28,7,6,14,15,36,7,35,76,10,26,25,50,23,31,124
Phoenix,44,"January 22, 2017",Toronto,0,1,115,103,1,48,115,45,20,6,1,15,28,38,7,40,79,9,22,31,57,26,28,131
Memphis,44,"January 18, 2017",Washington,0,0,101,104,1,48,101,45,20,8,1,12,20,28,17,33,83,8,25,25,58,27,34,106
Utah,44,"January 20, 2017",Dallas,0,1,112,107,1,53,112,53,17,8,5,15,26,38,15,38,82,8,23,30,59,28,39,125
Toronto,44,"January 22, 2017",Phoenix,1,0,103,115,1,48,103,35,19,9,8,9,20,28,7,33,83,7,27,26,56,30,35,110
L.A. Clippers,45,"January 21, 2017",Denver,0,0,98,123,1,48,98,35,23,5,2,7,23,25,10,40,96,10,32,30,64,8,8,100
Houston,45,"January 18, 2017",Milwaukee,1,1,111,92,1,48,111,46,25,9,12,10,17,33,13,43,95,14,44,29,51,11,15,137
Golden State,45,"January 23, 2017",Miami,0,0,102,105,1,48,102,43,27,9,4,14,20,36,7,41,88,8,30,33,58,12,20,116
Cleveland,45,"January 27, 2017",Brooklyn,1,1,124,116,1,48,124,47,26,4,6,14,14,38,9,49,92,13,36,36,56,13,20,143
New York,45,"January 21, 2017",Phoenix,1,0,105,107,1,48,105,46,20,6,3,12,20,31,15,40,89,11,21,29,68,14,16,117
Boston,45,"January 25, 2017",Houston,1,1,120,109,1,48,120,48,33,10,3,18,27,36,12,47,91,11,32,36,59,15,16,151
Indiana,45,"January 26, 2017",Minnesota,0,1,109,103,1,48,109,44,21,7,4,18,22,38,6,42,81,10,18,32,63,15,17,126
Detroit,45,"January 21, 2017",Washington,1,1,113,112,1,48,113,49,25,9,4,20,27,36,13,43,87,11,28,32,59,16,22,130
Miami,45,"January 23, 2017",Golden State,1,1,105,102,1,48,105,45,20,9,4,13,19,34,11,38,86,13,30,25,56,16,27,111
Washington,45,"January 24, 2017",Boston,1,1,123,108,1,48,123,42,21,7,4,15,18,35,7,48,83,9,20,39,63,18,21,144
Milwaukee,45,"January 25, 2017",Philadelphia,1,0,109,114,1,48,109,37,26,11,4,19,22,22,15,42,91,7,28,35,63,18,23,114
Minnesota,45,"January 24, 2017",Phoenix,0,1,112,111,1,48,112,42,24,8,4,15,21,32,10,44,84,6,17,38,67,18,24,129
Sacramento,45,"January 25, 2017",Cleveland,0,1,116,112,1,53,116,47,29,13,3,11,28,36,11,43,95,11,31,32,64,19,22,142
L.A. Lakers,45,"January 15, 2017",Detroit,1,0,97,102,1,48,97,50,19,2,4,14,18,41,9,36,83,6,26,30,57,19,24,106
Dallas,45,"January 25, 2017",New York,1,1,103,95,1,48,103,36,19,10,7,7,12,29,7,39,83,6,26,33,57,19,24,119
Oklahoma City,45,"January 23, 2017",Utah,0,1,97,95,1,48,97,45,17,6,6,10,23,37,8,36,83,6,20,30,63,19,25,108
Memphis,45,"January 20, 2017",Sacramento,1,1,107,91,1,48,107,58,21,6,4,15,24,43,15,38,83,11,28,27,55,20,25,131
Portland,45,"January 20, 2017",Philadelphia,0,0,92,93,1,48,92,46,16,8,6,13,20,34,12,33,89,6,19,27,70,20,28,91
Charlotte,45,"January 23, 2017",Washington,1,0,99,109,1,48,99,43,24,7,5,8,19,31,12,35,90,8,32,27,58,21,25,111
Atlanta,45,"January 23, 2017",L.A.Clippers,1,0,105,115,1,48,105,40,28,8,2,8,17,32,8,37,88,9,29,28,59,22,26,120
New Orleans,45,"January 23, 2017",Cleveland,1,1,124,122,1,48,124,43,26,8,11,8,22,35,8,43,87,16,39,27,48,22,30,152
Brooklyn,45,"January 25, 2017",Miami,1,0,106,109,1,48,106,33,20,3,4,15,25,29,4,35,80,13,35,22,45,23,26,103
Toronto,45,"January 24, 2017",San Antonio,1,0,106,108,1,48,106,46,10,9,8,13,25,36,10,38,84,6,25,32,59,24,28,116
Orlando,45,"January 20, 2017",Milwaukee,1,1,112,96,1,48,112,53,25,9,7,9,24,39,14,40,87,8,28,32,59,24,31,143
Philadelphia,45,"January 27, 2017",Houston,1,0,118,123,1,48,118,29,29,14,6,22,25,26,3,42,78,10,25,32,53,24,32,130
Utah,45,"January 21, 2017",Indiana,1,1,109,100,1,48,109,42,24,11,3,14,15,32,10,39,84,6,24,33,60,25,32,123
San Antonio,45,"January 24, 2017",Toronto,0,1,108,106,1,48,108,35,20,7,6,12,18,29,6,38,85,7,24,31,61,25,33,109
Phoenix,45,"January 24, 2017",Minnesota,1,0,111,112,1,48,111,44,20,7,4,15,23,31,13,38,86,7,19,31,67,28,32,119
Chicago,45,"January 21, 2017",Sacramento,1,1,102,99,1,48,102,48,22,7,7,11,18,34,14,34,83,6,17,28,66,28,33,121
Denver,45,"January 26, 2017",Phoenix,1,1,127,120,1,48,127,46,29,5,6,12,15,27,19,44,86,9,23,35,63,30,35,154
Orlando,46,"January 22, 2017",Golden State,1,0,98,118,1,48,98,41,25,9,7,12,21,29,12,42,96,7,28,35,68,7,16,105
Philadelphia,46,"January 29, 2017",Chicago,0,0,108,121,1,48,108,43,26,8,8,12,22,32,11,44,99,10,28,34,71,10,14,122
Dallas,46,"January 26, 2017",Oklahoma City,0,0,98,109,1,48,98,36,17,10,2,12,26,28,8,38,84,11,26,27,58,11,13,103
Toronto,46,"January 25, 2017",Memphis,0,0,99,101,1,48,99,45,16,6,4,8,22,32,13,39,92,10,34,29,58,11,19,101
Boston,46,"January 27, 2017",Orlando,1,1,128,98,1,48,128,47,39,8,4,10,17,40,7,50,89,16,34,34,55,12,15,174
Detroit,46,"January 23, 2017",Sacramento,1,0,104,109,1,48,104,37,27,8,1,14,21,32,5,41,82,10,28,31,54,12,17,117
New Orleans,46,"January 25, 2017",Oklahoma City,1,0,105,114,1,48,105,47,23,7,9,12,23,37,10,41,96,11,27,30,69,12,19,117
Washington,46,"January 27, 2017",Atlanta,0,1,112,86,1,48,112,52,26,12,10,18,24,39,13,43,89,13,31,30,58,13,19,142
Brooklyn,46,"January 27, 2017",Cleveland,0,0,116,124,1,48,116,37,23,9,2,10,15,33,4,43,87,16,33,27,54,14,16,131
Phoenix,46,"January 26, 2017",Denver,0,0,120,127,1,48,120,28,21,8,2,11,26,20,8,48,89,10,24,38,65,14,17,124
Houston,46,"January 20, 2017",Golden State,1,0,108,125,1,48,108,41,26,8,3,14,17,28,13,43,96,7,35,36,61,15,18,116
L.A. Lakers,46,"January 17, 2017",Denver,1,0,121,127,1,48,121,43,28,11,5,12,21,23,20,47,108,11,30,36,78,16,18,133
Atlanta,46,"January 25, 2017",Chicago,0,1,119,114,1,48,119,39,29,5,5,13,20,33,6,43,83,17,30,26,53,16,19,141
Cleveland,46,"January 29, 2017",Oklahoma City,1,1,107,91,1,48,107,52,22,9,6,10,16,43,9,41,92,8,29,33,63,17,22,130
L.A. Clippers,46,"January 23, 2017",Atlanta,0,1,115,105,1,48,115,46,23,4,8,11,19,36,10,42,84,14,24,28,60,17,22,138
Milwaukee,46,"January 27, 2017",Toronto,0,0,86,102,1,48,86,43,19,6,7,19,22,31,12,31,80,7,23,24,57,17,24,86
Miami,46,"January 25, 2017",Brooklyn,0,1,109,106,1,48,109,40,23,7,6,10,25,34,6,40,83,11,23,29,60,18,25,125
Utah,46,"January 23, 2017",Oklahoma City,1,0,95,97,1,48,95,41,16,10,7,10,18,34,7,36,83,5,21,31,62,18,26,104
Charlotte,46,"January 25, 2017",Golden State,1,0,103,113,1,48,103,43,26,6,6,14,18,31,12,38,92,7,23,31,69,20,21,115
Memphis,46,"January 21, 2017",Houston,1,0,95,119,1,48,95,41,19,10,4,12,17,27,14,33,89,9,34,24,55,20,28,93
Oklahoma City,46,"January 25, 2017",New Orleans,0,1,114,105,1,48,114,55,24,6,11,16,18,43,12,42,91,10,27,32,64,20,28,137
Minnesota,46,"January 26, 2017",Indiana,1,0,103,109,1,48,103,34,27,13,5,11,20,28,6,36,81,10,27,26,54,21,27,120
Chicago,46,"January 24, 2017",Orlando,0,1,100,92,1,48,100,44,12,13,6,13,19,38,6,35,77,7,22,28,55,23,30,113
Golden State,46,"January 25, 2017",Charlotte,0,1,113,103,1,48,113,41,23,7,14,12,19,36,5,39,82,11,28,28,54,24,27,140
San Antonio,46,"January 27, 2017",New Orleans,0,0,103,119,1,48,103,44,20,10,5,12,13,32,12,33,85,12,28,21,57,25,29,114
Sacramento,46,"January 27, 2017",Indiana,0,0,111,115,1,53,111,43,22,7,1,19,30,33,10,35,71,13,26,22,45,28,36,121
Indiana,46,"January 27, 2017",Sacramento,1,1,115,111,1,53,115,29,19,14,4,10,24,22,7,38,78,10,28,28,50,29,33,127
New York,46,"January 23, 2017",Indiana,0,1,109,103,1,48,109,43,19,8,7,14,21,37,6,35,76,8,22,27,54,31,35,127
Portland,46,"January 21, 2017",Boston,0,1,127,123,1,53,127,37,26,12,4,14,26,28,9,43,92,10,25,33,67,31,36,138
Denver,46,"January 28, 2017",Phoenix,0,1,123,112,1,48,123,48,17,7,3,14,25,39,9,39,80,8,25,31,55,37,42,138
Washington,47,"January 29, 2017",New Orleans,0,1,107,94,1,48,107,45,28,9,3,10,17,35,10,45,89,10,21,35,68,7,10,135
Detroit,47,"January 28, 2017",Miami,0,0,103,116,1,48,103,41,11,7,3,11,16,28,13,46,89,4,12,42,77,7,12,106
Miami,47,"January 27, 2017",Chicago,0,1,100,88,1,48,100,41,25,13,2,10,17,34,7,41,89,9,24,32,65,9,11,121
New York,47,"January 25, 2017",Dallas,0,0,95,103,1,48,95,55,17,4,2,18,21,37,18,39,92,7,23,32,69,10,12,100
New Orleans,47,"January 27, 2017",San Antonio,1,1,119,103,1,48,119,54,29,8,5,14,20,39,15,48,93,13,30,35,63,10,14,152
L.A. Lakers,47,"January 20, 2017",Indiana,1,1,108,96,1,48,108,51,27,15,4,23,20,35,16,41,87,14,33,27,54,12,15,133
Golden State,47,"January 28, 2017",L.A.Clippers,1,1,144,98,1,48,144,48,35,9,7,11,17,39,9,57,92,17,34,40,58,13,16,194
Charlotte,47,"January 27, 2017",New York,0,0,107,110,1,48,107,47,18,5,4,13,16,38,9,40,90,13,37,27,53,14,15,117
Dallas,47,"January 29, 2017",San Antonio,0,1,105,101,1,48,105,41,20,6,5,6,19,35,6,39,87,12,34,27,53,15,16,122
Portland,47,"January 25, 2017",L.A.Lakers,1,1,105,98,1,48,105,49,17,5,4,11,12,40,9,43,90,4,15,39,75,15,20,117
Orlando,47,"January 24, 2017",Chicago,1,0,92,100,1,48,92,48,18,7,2,19,18,36,12,35,85,7,22,28,63,15,20,93
Cleveland,47,"January 30, 2017",Dallas,0,0,97,104,1,48,97,42,17,6,3,17,17,36,6,35,75,12,32,23,43,15,21,102
San Antonio,47,"January 29, 2017",Dallas,1,0,101,105,1,48,101,46,26,2,5,11,20,40,6,39,83,8,22,31,61,15,23,117
Utah,47,"January 24, 2017",Denver,0,0,93,103,1,48,93,40,19,6,3,11,21,32,8,35,85,7,22,28,63,16,21,95
Sacramento,47,"January 28, 2017",Charlotte,0,1,109,106,1,48,109,38,27,6,5,9,23,30,8,41,79,11,27,30,52,16,26,128
Atlanta,47,"January 27, 2017",Washington,1,0,86,112,1,48,86,41,18,9,8,19,16,33,8,30,83,9,31,21,52,17,25,82
Toronto,47,"January 27, 2017",Milwaukee,1,1,102,86,1,48,102,47,20,9,11,14,19,35,12,37,84,10,25,27,59,18,23,123
Denver,47,"January 31, 2017",L.A.Lakers,0,0,116,120,1,48,116,51,26,12,5,11,18,31,20,41,99,15,27,26,72,19,23,137
Memphis,47,"January 25, 2017",Toronto,1,1,101,99,1,48,101,45,18,3,7,9,17,36,9,36,78,10,22,26,56,19,25,117
Brooklyn,47,"January 28, 2017",Minnesota,0,0,109,129,1,48,109,40,20,6,6,14,18,35,5,41,85,7,21,34,64,20,25,118
Chicago,47,"January 25, 2017",Atlanta,1,0,114,119,1,48,114,42,18,6,5,6,16,29,13,43,94,8,27,35,67,20,26,122
Houston,47,"January 21, 2017",Memphis,0,1,119,95,1,48,119,46,27,11,6,12,25,40,6,41,80,16,42,25,38,21,25,154
Philadelphia,47,"January 30, 2017",Sacramento,1,1,122,119,1,48,122,29,32,13,2,14,18,20,9,45,83,11,31,34,52,21,26,141
Indiana,47,"January 29, 2017",Houston,1,1,120,101,1,48,120,42,28,9,7,10,21,35,7,47,87,5,21,42,66,21,26,151
Boston,47,"January 28, 2017",Milwaukee,0,1,112,108,1,53,112,44,26,6,7,13,23,35,9,37,89,14,40,23,49,24,30,124
Phoenix,47,"January 28, 2017",Denver,1,0,112,123,1,48,112,43,20,9,3,10,36,32,11,41,91,6,21,35,70,24,32,119
Milwaukee,47,"January 28, 2017",Boston,1,0,108,112,1,53,108,47,23,6,6,15,25,38,9,37,87,9,21,28,66,25,32,118
Minnesota,47,"January 28, 2017",Brooklyn,1,1,129,109,1,48,129,48,27,8,8,11,21,36,12,47,92,9,20,38,72,26,32,158
Oklahoma City,47,"January 26, 2017",Dallas,1,1,109,98,1,48,109,43,13,7,2,16,17,36,7,37,72,9,22,28,50,26,36,113
L.A. Clippers,47,"January 24, 2017",Philadelphia,0,0,110,121,1,48,110,46,17,4,1,17,22,35,11,33,71,18,34,15,37,26,41,108
New Orleans,48,"January 29, 2017",Washington,1,0,94,107,1,48,94,42,25,8,3,14,12,32,10,38,84,10,32,28,52,8,15,105
New York,48,"January 27, 2017",Charlotte,1,1,110,107,1,48,110,48,22,8,10,10,18,37,11,46,96,9,27,37,69,9,13,134
Oklahoma City,48,"January 29, 2017",Cleveland,0,0,91,107,1,48,91,55,20,5,4,16,19,42,13,37,100,6,26,31,74,11,16,91
Washington,48,"January 31, 2017",New York,1,1,117,101,1,48,117,46,27,4,5,12,25,37,9,49,88,7,22,42,66,12,15,145
Orlando,48,"January 27, 2017",Boston,0,0,98,128,1,48,98,37,29,7,2,11,15,31,6,38,87,9,25,29,62,13,18,108
L.A. Lakers,48,"January 22, 2017",Dallas,0,0,73,122,1,48,73,32,11,3,4,17,20,27,5,28,73,3,21,25,52,14,17,58
L.A. Clippers,48,"January 28, 2017",Golden State,0,0,98,144,1,48,98,32,24,7,2,14,18,24,8,36,82,12,28,24,54,14,22,95
Cleveland,48,"February 1, 2017",Minnesota,1,1,125,97,1,48,125,48,37,10,10,10,13,36,12,48,89,15,37,33,52,14,22,171
Milwaukee,48,"February 1, 2017",Utah,0,0,88,104,1,48,88,39,19,10,7,17,21,30,9,32,73,9,23,23,50,15,25,95
Dallas,48,"January 30, 2017",Cleveland,1,1,104,97,1,48,104,42,19,11,2,9,17,32,10,39,86,9,32,30,54,17,18,121
Brooklyn,48,"January 30, 2017",Miami,0,0,96,104,1,48,96,53,16,7,4,16,23,38,15,37,87,4,26,33,61,18,22,106
Miami,48,"January 28, 2017",Detroit,1,1,116,103,1,48,116,38,18,5,6,13,19,29,9,42,79,14,28,28,51,18,23,128
Chicago,48,"January 27, 2017",Miami,1,0,88,100,1,48,88,43,19,7,9,20,12,34,9,33,79,3,13,30,66,19,25,94
Philadelphia,48,"February 1, 2017",Dallas,0,0,95,113,1,48,95,39,21,5,2,13,21,34,5,35,77,6,22,29,55,19,26,100
Minnesota,48,"January 30, 2017",Orlando,1,1,111,105,1,53,111,51,29,3,11,11,20,41,10,40,92,12,29,28,63,19,26,135
Portland,48,"January 27, 2017",Memphis,1,1,112,109,1,48,112,33,24,2,3,12,26,25,8,38,81,16,35,22,46,20,21,118
Detroit,48,"January 30, 2017",Boston,0,0,109,113,1,48,109,51,18,6,7,7,23,39,12,43,97,3,27,40,70,20,29,121
Charlotte,48,"January 28, 2017",Sacramento,1,0,106,109,1,48,106,34,24,4,8,11,25,27,7,36,75,12,37,24,38,22,24,124
Houston,48,"January 23, 2017",Milwaukee,0,0,114,127,1,48,114,28,26,11,4,21,22,23,5,39,77,14,35,25,42,22,28,118
Indiana,48,"February 1, 2017",Orlando,0,1,98,88,1,48,98,38,25,5,1,17,23,33,5,33,69,9,20,24,49,23,26,111
Utah,48,"January 26, 2017",L.A.Lakers,1,1,96,88,1,48,96,44,13,7,6,8,10,34,10,33,81,6,26,27,55,24,28,106
Sacramento,48,"January 30, 2017",Philadelphia,0,0,119,122,1,48,119,33,31,7,3,20,28,24,9,41,74,13,29,28,45,24,29,135
Memphis,48,"January 27, 2017",Portland,0,0,109,112,1,48,109,42,24,6,5,11,19,32,10,37,77,9,26,28,51,26,33,128
Denver,48,"February 1, 2017",Memphis,1,0,99,119,1,48,99,45,25,7,2,17,17,34,11,32,80,9,25,23,55,26,35,104
San Antonio,48,"January 31, 2017",Oklahoma City,1,1,108,94,1,48,108,50,16,12,13,17,25,40,10,37,86,7,21,30,65,27,38,122
Boston,48,"January 30, 2017",Detroit,1,1,113,109,1,48,113,44,23,6,5,9,18,38,6,36,82,13,32,23,50,28,33,131
Atlanta,48,"January 29, 2017",New York,1,1,142,139,1,68,142,64,36,4,2,14,24,47,17,52,119,10,31,42,88,28,40,155
Toronto,48,"January 29, 2017",Orlando,1,0,113,114,1,48,113,40,19,8,3,11,20,31,9,36,79,12,28,24,51,29,36,122
Phoenix,48,"January 30, 2017",Memphis,1,0,96,115,1,48,96,42,11,8,8,17,19,29,13,31,74,5,19,26,55,29,39,95
Golden State,48,"January 29, 2017",Portland,0,1,113,111,1,48,113,39,28,13,6,18,18,31,8,36,79,8,26,28,53,33,39,132
Minnesota,49,"February 1, 2017",Cleveland,0,0,97,125,1,48,97,38,26,7,3,13,19,26,12,41,94,7,21,34,73,8,10,103
Memphis,49,"January 28, 2017",Utah,0,1,102,95,1,48,102,31,13,8,1,7,23,24,7,41,80,11,26,30,54,9,10,108
Portland,49,"January 29, 2017",Golden State,1,0,111,113,1,48,111,42,26,11,2,18,24,33,9,46,93,10,27,36,66,9,12,124
Golden State,49,"February 1, 2017",Charlotte,1,1,126,111,1,48,126,47,35,9,12,10,18,38,9,47,96,21,48,26,48,11,14,167
Brooklyn,49,"February 1, 2017",New York,1,0,90,95,1,48,90,49,17,4,7,20,24,37,12,37,88,5,25,32,63,11,16,91
Toronto,49,"January 31, 2017",New Orleans,1,1,108,106,1,53,108,53,19,5,6,14,19,40,13,43,94,10,31,33,63,12,15,123
Detroit,49,"February 1, 2017",New Orleans,1,1,118,98,1,48,118,42,28,9,0,10,13,37,5,48,88,10,26,38,62,12,17,142
L.A. Lakers,49,"January 25, 2017",Portland,0,0,98,105,1,48,98,51,16,5,9,13,17,37,14,37,94,11,29,26,65,13,14,108
Cleveland,49,"February 4, 2017",New York,0,1,111,104,1,48,111,49,20,3,0,15,19,37,12,41,84,16,40,25,44,13,18,120
New Orleans,49,"January 31, 2017",Toronto,0,0,106,108,1,53,106,47,17,11,7,11,16,34,13,40,94,12,30,28,64,14,19,118
Miami,49,"January 30, 2017",Brooklyn,1,1,104,96,1,48,104,34,22,9,8,11,18,29,5,39,82,11,26,28,56,15,23,115
Sacramento,49,"January 31, 2017",Houston,0,0,83,105,1,48,83,45,22,9,7,11,17,35,10,30,86,8,29,22,57,15,26,88
Washington,49,"February 2, 2017",L.A.Lakers,1,1,116,108,1,48,116,45,27,11,6,10,19,33,12,44,96,12,33,32,63,16,21,138
Philadelphia,49,"February 2, 2017",San Antonio,0,0,86,102,1,48,86,48,21,10,5,23,23,34,14,30,88,9,25,21,63,17,23,83
Atlanta,49,"February 1, 2017",Miami,0,0,93,116,1,48,93,43,13,10,6,15,14,34,9,34,86,7,26,27,60,18,21,95
Milwaukee,49,"February 3, 2017",Denver,0,0,117,121,1,48,117,38,26,9,13,18,26,32,6,45,83,9,24,36,59,18,23,142
New York,49,"January 29, 2017",Atlanta,0,0,139,142,1,68,139,63,32,9,11,12,39,48,15,51,128,18,51,33,77,19,23,161
Orlando,49,"January 29, 2017",Toronto,0,1,114,113,1,48,114,36,25,6,6,12,28,30,6,42,79,10,23,32,56,20,26,132
San Antonio,49,"February 2, 2017",Philadelphia,1,1,102,86,1,48,102,57,26,15,9,19,20,43,14,38,89,6,21,32,68,20,27,132
Charlotte,49,"January 31, 2017",Portland,0,0,98,115,1,48,98,42,20,3,6,9,13,39,3,33,83,11,31,22,52,21,25,106
Chicago,49,"January 29, 2017",Philadelphia,1,1,121,108,1,48,121,49,29,8,5,10,11,39,10,45,89,8,14,37,75,23,28,153
Dallas,49,"February 1, 2017",Philadelphia,1,1,113,95,1,48,113,51,22,10,4,11,19,36,15,40,86,10,26,30,60,23,28,138
Indiana,49,"February 3, 2017",Brooklyn,0,1,106,97,1,48,106,49,20,11,10,14,19,37,12,37,86,8,20,29,66,24,31,126
Boston,49,"February 1, 2017",Toronto,1,1,109,104,1,48,109,39,24,6,2,9,21,27,12,36,87,12,36,24,51,25,30,115
Utah,49,"January 28, 2017",Memphis,1,0,95,102,1,48,95,31,19,3,4,13,18,27,4,29,62,10,25,19,37,27,29,104
Oklahoma City,49,"January 31, 2017",San Antonio,0,0,94,108,1,48,94,50,21,12,7,20,30,38,12,30,85,7,28,23,57,27,32,104
Houston,49,"January 25, 2017",Boston,0,0,109,120,1,48,109,30,28,8,5,17,18,24,6,36,77,10,31,26,46,27,38,111
Phoenix,49,"February 1, 2017",L.A.Clippers,1,0,114,124,1,48,114,45,21,5,3,13,27,27,18,39,96,7,20,32,76,29,35,112
L.A. Clippers,49,"February 1, 2017",Phoenix,0,1,124,114,1,48,124,45,20,10,9,10,28,37,8,44,84,5,19,39,65,31,38,151
Denver,49,"February 3, 2017",Milwaukee,1,1,121,117,1,48,121,48,31,7,5,14,13,30,18,40,89,9,28,31,61,32,44,137
Denver,50,"February 4, 2017",San Antonio,0,0,97,121,1,48,97,42,22,7,1,21,19,26,16,41,92,10,26,31,66,5,10,92
Indiana,50,"February 4, 2017",Detroit,1,1,105,84,1,48,105,41,22,11,4,6,17,34,7,44,91,7,24,37,67,10,15,125
New Orleans,50,"February 1, 2017",Detroit,0,0,98,118,1,48,98,35,21,6,5,14,15,32,3,41,82,5,21,36,61,11,14,107
L.A. Lakers,50,"January 26, 2017",Utah,0,0,88,96,1,48,88,48,13,5,2,12,24,38,10,36,84,4,14,32,70,12,13,95
Orlando,50,"January 30, 2017",Minnesota,0,0,105,111,1,53,105,48,22,7,3,11,25,37,11,41,96,10,35,31,61,13,19,113
Oklahoma City,50,"February 1, 2017",Chicago,1,0,100,128,1,48,100,37,17,6,5,9,23,26,11,38,100,10,37,28,63,14,17,91
Miami,50,"February 1, 2017",Atlanta,1,1,116,93,1,48,116,47,23,10,11,12,18,37,10,45,93,12,32,33,61,14,19,142
Toronto,50,"February 1, 2017",Boston,0,0,104,109,1,48,104,41,17,6,5,15,29,33,8,41,78,8,31,33,47,14,25,110
Golden State,50,"February 2, 2017",L.A.Clippers,0,1,133,120,1,48,133,46,38,10,2,11,26,31,15,52,99,14,34,38,65,15,18,168
Minnesota,50,"February 3, 2017",Detroit,0,0,108,116,1,48,108,40,25,5,6,13,19,29,11,44,89,5,17,39,72,15,19,122
Sacramento,50,"February 3, 2017",Phoenix,1,0,103,105,1,48,103,43,23,5,4,13,25,37,6,38,85,10,27,28,58,17,22,113
Detroit,50,"February 3, 2017",Minnesota,1,1,116,108,1,48,116,50,24,7,4,10,14,32,18,44,98,11,26,33,72,17,22,132
Atlanta,50,"February 2, 2017",Houston,0,1,113,108,1,48,113,56,26,8,5,20,20,48,8,44,85,8,30,36,55,17,23,141
Washington,50,"February 4, 2017",New Orleans,1,1,105,91,1,48,105,46,20,10,6,12,19,39,7,38,83,10,31,28,52,19,22,127
Dallas,50,"February 3, 2017",Portland,0,1,108,104,1,48,108,36,15,3,4,4,24,34,2,36,76,17,31,19,45,19,23,118
Portland,50,"January 31, 2017",Charlotte,1,1,115,98,1,48,115,51,23,8,2,8,18,40,11,42,93,11,31,31,62,20,23,137
Memphis,50,"January 30, 2017",Phoenix,0,1,115,96,1,48,115,44,25,13,2,17,27,34,10,39,80,16,28,23,52,21,24,138
San Antonio,50,"February 4, 2017",Denver,1,1,121,97,1,48,121,38,29,13,8,14,15,31,7,45,79,10,21,35,58,21,26,156
Utah,50,"February 1, 2017",Milwaukee,1,1,104,88,1,48,104,46,22,11,2,15,23,35,11,36,78,11,29,25,49,21,27,122
Brooklyn,50,"February 3, 2017",Indiana,1,0,97,106,1,48,97,44,20,7,4,19,22,35,9,32,86,11,28,21,58,22,23,98
Boston,50,"February 3, 2017",L.A.Lakers,1,1,113,107,1,48,113,47,28,8,1,16,19,40,7,39,82,13,35,26,47,22,28,132
Cleveland,50,"February 6, 2017",Washington,0,1,140,135,1,53,140,46,31,7,2,20,26,34,12,49,92,19,38,30,54,23,28,158
Charlotte,50,"February 1, 2017",Golden State,0,0,111,126,1,48,111,45,33,4,3,10,14,39,6,39,88,9,30,30,58,24,26,135
Chicago,50,"February 1, 2017",Oklahoma City,0,1,128,100,1,48,128,42,25,7,2,9,19,38,4,49,81,6,15,43,66,24,30,157
Philadelphia,50,"February 4, 2017",Miami,0,0,102,125,1,48,102,33,20,10,1,15,21,27,6,35,84,6,23,29,61,26,31,97
Milwaukee,50,"February 4, 2017",Phoenix,0,1,137,112,1,48,137,44,29,9,11,16,25,35,9,52,82,7,17,45,65,26,35,175
Houston,50,"January 27, 2017",Philadelphia,0,1,123,118,1,48,123,41,25,10,4,23,29,35,6,42,81,12,31,30,50,27,28,140
New York,50,"January 31, 2017",Washington,0,0,101,117,1,48,101,51,18,8,2,12,17,29,22,34,93,5,24,29,69,28,35,102
Phoenix,50,"February 3, 2017",Sacramento,0,1,105,103,1,48,105,39,11,7,3,11,21,33,6,32,77,12,29,20,48,29,35,103
L.A. Clippers,50,"February 2, 2017",Golden State,1,0,120,133,1,48,120,37,24,7,7,15,18,28,9,40,80,10,25,30,55,30,39,131
San Antonio,51,"February 6, 2017",Memphis,0,0,74,89,1,48,74,44,11,8,6,16,20,33,11,30,82,4,19,26,63,10,18,67
Dallas,51,"February 6, 2017",Denver,0,0,87,110,1,48,87,29,25,8,3,10,18,26,3,34,79,8,26,26,53,11,17,91
New Orleans,51,"February 4, 2017",Washington,0,0,91,105,1,48,91,42,18,4,6,15,16,33,9,37,84,5,17,32,67,12,22,89
Chicago,51,"February 3, 2017",Houston,0,0,117,121,1,53,117,53,30,7,7,14,23,39,14,48,100,8,25,40,75,13,18,143
L.A. Lakers,51,"January 31, 2017",Denver,1,1,120,116,1,48,120,44,25,7,10,15,16,34,10,47,89,12,26,35,63,14,18,145
Denver,51,"February 6, 2017",Dallas,1,1,110,87,1,48,110,49,28,7,10,15,19,39,10,42,84,11,28,31,56,15,16,146
Charlotte,51,"February 4, 2017",Utah,0,0,98,105,1,48,98,38,20,7,3,9,20,35,3,35,82,13,33,22,49,15,18,107
Portland,51,"February 3, 2017",Dallas,1,0,104,108,1,48,104,44,16,3,4,9,19,32,12,40,88,9,30,31,58,15,20,109
Memphis,51,"February 1, 2017",Denver,0,1,119,99,1,48,119,46,28,6,4,8,24,35,11,45,92,14,30,31,62,15,20,143
Sacramento,51,"February 4, 2017",Golden State,1,1,109,106,1,53,109,46,25,11,4,16,18,38,8,43,88,7,23,36,65,16,19,131
Detroit,51,"February 4, 2017",Indiana,0,0,84,105,1,48,84,44,18,2,6,21,13,36,8,31,75,6,17,25,58,16,20,85
Toronto,51,"February 3, 2017",Orlando,0,0,94,102,1,48,94,44,15,5,5,11,21,31,13,34,87,10,28,24,59,16,21,94
Utah,51,"February 4, 2017",Charlotte,1,1,105,98,1,48,105,51,16,5,4,13,18,40,11,38,81,13,33,25,48,16,24,117
Milwaukee,51,"February 8, 2017",Miami,1,0,88,106,1,48,88,34,18,10,4,12,18,29,5,33,71,6,15,27,56,16,28,92
Boston,51,"February 5, 2017",L.A.Clippers,1,1,107,102,1,48,107,45,24,9,3,11,21,36,9,37,88,16,52,21,36,17,20,123
Miami,51,"February 4, 2017",Philadelphia,1,1,125,102,1,48,125,49,28,6,5,21,24,39,10,48,82,12,22,36,60,17,23,152
Brooklyn,51,"February 5, 2017",Toronto,1,0,95,103,1,48,95,43,19,8,7,21,19,36,7,32,76,13,34,19,42,18,21,104
Minnesota,51,"February 4, 2017",Memphis,1,0,99,107,1,48,99,46,22,4,3,12,27,30,16,35,84,10,26,25,58,19,24,108
Golden State,51,"February 4, 2017",Sacramento,0,0,106,109,1,53,106,40,22,10,10,17,17,33,7,36,87,15,44,21,43,19,24,115
Philadelphia,51,"February 6, 2017",Detroit,0,0,96,113,1,48,96,41,19,8,0,13,17,30,11,36,85,5,28,31,57,19,28,93
Indiana,51,"February 6, 2017",Oklahoma City,1,1,93,90,1,48,93,37,19,7,9,10,17,24,13,33,87,8,26,25,61,19,29,91
New York,51,"February 1, 2017",Brooklyn,0,1,95,90,1,48,95,58,23,16,7,13,18,37,21,35,99,6,27,29,72,19,31,110
Orlando,51,"February 1, 2017",Indiana,1,0,88,98,1,48,88,35,17,12,3,14,22,28,7,31,77,6,24,25,53,20,28,87
Atlanta,51,"February 4, 2017",Orlando,1,1,113,86,1,48,113,48,28,8,2,15,20,38,10,41,78,10,28,31,50,21,27,141
Houston,51,"January 29, 2017",Indiana,0,0,101,120,1,48,101,41,21,7,6,15,24,30,11,34,83,11,39,23,44,22,25,109
L.A. Clippers,51,"February 5, 2017",Boston,0,0,102,107,1,48,102,46,22,4,0,13,13,38,8,35,84,10,29,25,55,22,28,106
Washington,51,"February 6, 2017",Cleveland,1,0,135,140,1,53,135,43,29,9,5,12,25,32,11,50,99,12,29,38,70,23,26,157
Cleveland,51,"February 8, 2017",Indiana,0,1,132,117,1,48,132,39,24,7,5,9,16,34,5,46,84,16,36,30,48,24,26,158
Phoenix,51,"February 4, 2017",Milwaukee,1,0,112,137,1,48,112,40,22,9,3,16,28,26,14,38,91,11,28,27,63,25,30,112
Oklahoma City,51,"February 3, 2017",Memphis,1,1,114,102,1,48,114,48,21,7,3,20,21,31,17,38,80,13,26,25,54,25,33,123
Miami,52,"February 6, 2017",Minnesota,0,1,115,113,1,48,115,38,27,5,5,17,21,25,13,45,86,15,28,30,58,10,14,128
Golden State,52,"February 8, 2017",Chicago,1,1,123,92,1,48,123,46,37,9,5,12,17,40,6,48,86,15,28,33,58,12,13,169
Utah,52,"February 6, 2017",Atlanta,0,1,120,95,1,48,120,44,31,9,7,12,23,35,9,49,80,10,26,39,54,12,18,162
L.A. Clippers,52,"February 6, 2017",Toronto,0,0,109,118,1,48,109,39,24,7,5,9,19,30,9,42,90,13,35,29,55,12,18,121
Denver,52,"February 8, 2017",Atlanta,0,0,106,117,1,48,106,49,25,8,4,10,20,28,21,40,100,13,44,27,56,13,21,114
Sacramento,52,"February 6, 2017",Chicago,1,0,107,112,1,48,107,40,27,4,5,15,25,31,9,41,79,11,28,30,51,14,16,128
New York,52,"February 4, 2017",Cleveland,1,0,104,111,1,48,104,42,23,9,7,10,20,29,13,39,86,12,31,27,55,14,28,114
Houston,52,"January 31, 2017",Sacramento,1,1,105,83,1,48,105,60,28,4,3,14,24,49,11,38,85,14,45,24,40,15,22,132
Detroit,52,"February 6, 2017",Philadelphia,1,1,113,96,1,48,113,60,22,8,4,12,19,41,19,46,99,5,22,41,77,16,17,141
L.A. Lakers,52,"February 2, 2017",Washington,0,0,108,116,1,48,108,47,19,6,8,20,23,35,12,40,87,12,39,28,48,16,22,115
Brooklyn,52,"February 7, 2017",Charlotte,0,0,107,111,1,48,107,45,26,3,9,15,23,41,4,39,86,12,36,27,50,17,21,124
Toronto,52,"February 5, 2017",Brooklyn,0,1,103,95,1,48,103,45,21,8,4,11,18,37,8,40,87,5,19,35,68,18,20,121
New Orleans,52,"February 6, 2017",Phoenix,1,1,111,106,1,48,111,48,20,11,11,13,25,39,9,42,92,9,26,33,66,18,22,134
Portland,52,"February 5, 2017",Oklahoma City,0,0,99,105,1,48,99,44,15,6,4,12,22,33,11,35,87,10,28,25,59,19,21,102
Memphis,52,"February 3, 2017",Oklahoma City,0,0,102,114,1,48,102,29,21,10,5,12,28,21,8,40,83,3,19,37,64,19,22,109
Chicago,52,"February 6, 2017",Sacramento,0,1,112,107,1,48,112,35,21,10,3,8,17,27,8,43,81,6,19,37,62,20,31,124
Phoenix,52,"February 6, 2017",New Orleans,0,0,106,111,1,48,106,49,26,7,9,16,23,40,9,40,93,5,27,35,66,21,25,124
Oklahoma City,52,"February 5, 2017",Portland,1,1,105,99,1,48,105,56,18,9,5,12,17,39,17,40,98,4,18,36,80,21,28,116
San Antonio,52,"February 8, 2017",Philadelphia,0,1,111,103,1,48,111,47,24,3,5,15,22,41,6,39,74,11,22,28,52,22,25,137
Indiana,52,"February 8, 2017",Cleveland,1,0,117,132,1,48,117,38,24,7,2,12,18,31,7,41,82,13,25,28,57,22,26,131
Minnesota,52,"February 6, 2017",Miami,1,0,113,115,1,48,113,34,25,13,1,10,15,26,8,43,80,5,11,38,69,22,28,133
Philadelphia,52,"February 8, 2017",San Antonio,1,0,103,111,1,48,103,35,23,8,2,6,19,28,7,34,83,13,34,21,49,22,29,109
Cleveland,52,"February 9, 2017",Oklahoma City,0,0,109,118,1,48,109,35,14,9,6,16,14,30,5,38,79,10,21,28,58,23,30,109
Orlando,52,"February 3, 2017",Toronto,1,1,102,94,1,48,102,46,22,4,7,11,16,35,11,37,80,5,14,32,66,23,32,118
Atlanta,52,"February 6, 2017",Utah,1,0,95,120,1,48,95,30,16,6,3,12,18,23,7,33,74,6,17,27,57,23,32,88
Boston,52,"February 8, 2017",Sacramento,0,0,92,108,1,48,92,39,18,8,2,17,19,32,7,29,73,10,32,19,41,24,27,95
Charlotte,52,"February 7, 2017",Brooklyn,1,1,111,107,1,48,111,51,19,6,7,7,17,39,12,40,102,7,26,33,76,24,29,120
Washington,52,"February 8, 2017",Brooklyn,0,1,114,110,1,53,114,54,21,9,5,12,26,37,17,40,97,9,25,31,72,25,33,126
Milwaukee,52,"February 10, 2017",L.A.Lakers,1,0,114,122,1,48,114,34,27,11,5,20,29,30,4,40,76,8,28,32,48,26,31,130
Dallas,52,"February 7, 2017",Portland,1,0,113,114,1,48,113,30,16,6,6,7,22,28,2,37,75,12,28,25,47,27,32,121
Denver,53,"February 10, 2017",New York,0,1,131,123,1,48,131,44,30,6,5,15,11,28,16,54,95,16,32,38,63,7,10,157
San Antonio,53,"February 10, 2017",Detroit,0,1,103,92,1,48,103,52,27,4,5,18,18,41,11,41,82,9,19,32,63,12,15,129
Charlotte,53,"February 9, 2017",Houston,1,0,95,107,1,48,95,47,26,8,4,21,17,37,10,37,85,8,26,29,59,13,14,110
Indiana,53,"February 10, 2017",Washington,0,0,107,112,1,48,107,42,29,3,5,11,22,32,10,45,92,4,21,41,71,13,15,126
Miami,53,"February 8, 2017",Milwaukee,0,1,106,88,1,48,106,48,23,5,5,15,21,34,14,41,86,11,33,30,53,13,18,122
Sacramento,53,"February 8, 2017",Boston,1,1,108,92,1,48,108,40,24,11,1,14,18,36,4,42,84,10,25,32,59,14,15,127
Chicago,53,"February 8, 2017",Golden State,0,0,92,123,1,48,92,44,25,7,2,14,17,29,15,37,92,4,24,33,68,14,19,96
Atlanta,53,"February 8, 2017",Denver,1,1,117,106,1,48,117,48,31,6,4,10,18,36,12,47,93,8,27,39,66,15,18,147
Oklahoma City,53,"February 6, 2017",Indiana,0,0,90,93,1,48,90,61,17,6,11,16,21,41,20,34,88,7,28,27,60,15,21,109
Detroit,53,"February 8, 2017",L.A.Lakers,1,1,121,102,1,48,121,52,32,11,6,14,14,38,14,51,97,4,16,47,81,15,24,153
Utah,53,"February 8, 2017",New Orleans,0,1,127,94,1,48,127,48,25,9,2,8,19,36,12,48,88,14,32,34,56,17,21,159
Cleveland,53,"February 11, 2017",Denver,1,1,125,109,1,48,125,45,30,9,4,15,16,37,8,46,84,15,30,31,54,18,22,156
Portland,53,"February 7, 2017",Dallas,0,1,114,113,1,48,114,55,17,6,2,15,26,37,18,42,86,11,28,31,58,19,24,130
Dallas,53,"February 9, 2017",Utah,1,1,112,105,1,53,112,38,21,12,3,11,19,32,6,44,87,5,20,39,67,19,25,126
New Orleans,53,"February 8, 2017",Utah,1,0,94,127,1,48,94,37,17,6,6,13,17,30,7,35,77,5,24,30,53,19,25,99
L.A. Lakers,53,"February 3, 2017",Boston,0,0,107,113,1,48,107,52,24,9,3,12,23,37,15,37,94,14,38,23,56,19,26,119
L.A. Clippers,53,"February 8, 2017",New York,0,1,119,115,1,48,119,47,22,8,3,11,20,33,14,45,92,10,25,35,67,19,28,132
Washington,53,"February 10, 2017",Indiana,1,1,112,107,1,48,112,46,29,8,4,11,13,32,14,41,88,10,29,31,59,20,30,131
Philadelphia,53,"February 9, 2017",Orlando,0,1,112,111,1,48,112,45,25,13,5,15,19,32,13,40,95,11,28,29,67,21,27,124
Boston,53,"February 9, 2017",Portland,0,1,120,111,1,48,120,43,23,8,1,8,21,29,14,44,91,10,30,34,61,22,27,135
Orlando,53,"February 4, 2017",Atlanta,0,0,86,113,1,48,86,33,17,8,4,13,19,26,7,27,78,7,27,20,51,25,28,81
Houston,53,"February 2, 2017",Atlanta,1,0,108,113,1,48,108,38,19,11,3,9,20,31,7,35,93,13,51,22,42,25,33,104
Brooklyn,53,"February 8, 2017",Washington,1,0,110,114,1,53,110,55,20,6,5,16,24,40,15,38,91,9,33,29,58,25,36,116
Toronto,53,"February 6, 2017",L.A.Clippers,1,1,118,109,1,48,118,47,20,6,1,9,23,36,11,41,84,10,24,31,60,26,29,137
New York,53,"February 6, 2017",L.A.Lakers,1,0,107,121,1,48,107,40,16,4,4,16,24,34,6,37,82,7,21,30,61,26,33,103
Minnesota,53,"February 8, 2017",Toronto,1,1,112,109,1,48,112,36,22,8,3,8,20,25,11,39,80,7,19,32,61,27,30,129
Phoenix,53,"February 8, 2017",Memphis,0,0,91,110,1,48,91,46,13,12,5,15,27,28,18,29,87,5,23,24,64,28,34,88
Milwaukee,53,"February 11, 2017",Indiana,0,1,116,100,1,48,116,37,28,7,6,6,18,29,8,35,73,17,31,18,42,29,37,142
Golden State,53,"February 10, 2017",Memphis,0,1,122,107,1,48,122,35,31,14,13,12,26,30,5,39,77,15,33,24,44,29,38,156
Memphis,53,"February 4, 2017",Minnesota,0,1,107,99,1,48,107,42,17,7,3,9,25,29,13,32,77,10,28,22,49,33,39,116
Dallas,54,"February 11, 2017",Orlando,1,1,112,80,1,48,112,51,32,10,3,14,17,39,12,45,91,17,35,28,56,5,6,147
Detroit,54,"February 10, 2017",San Antonio,1,0,92,103,1,48,92,35,22,8,3,10,15,28,7,39,92,5,17,34,75,9,13,93
Oklahoma City,54,"February 9, 2017",Cleveland,1,1,118,109,1,48,118,51,24,10,5,13,23,34,17,50,106,8,27,42,79,10,13,136
Phoenix,54,"February 10, 2017",Chicago,1,1,115,97,1,48,115,43,25,4,8,8,18,30,13,48,95,8,19,40,76,11,13,138
L.A. Clippers,54,"February 11, 2017",Charlotte,0,1,107,102,1,48,107,50,26,3,6,13,21,40,10,40,85,14,34,26,51,13,20,127
Utah,54,"February 9, 2017",Dallas,0,0,105,112,1,53,105,43,26,8,3,21,26,32,11,39,85,13,29,26,56,14,17,115
Orlando,54,"February 7, 2017",Houston,0,0,104,128,1,48,104,47,28,7,4,16,23,37,10,42,88,6,25,36,63,14,20,122
Toronto,54,"February 8, 2017",Minnesota,0,0,109,112,1,48,109,36,19,6,3,13,22,26,10,42,79,11,28,31,51,14,20,117
Sacramento,54,"February 10, 2017",Atlanta,1,1,108,107,1,48,108,39,27,12,2,18,27,31,8,38,80,18,36,20,44,14,21,121
New York,54,"February 8, 2017",L.A.Clippers,1,0,115,119,1,48,115,41,25,9,5,11,22,29,12,46,92,8,27,38,65,15,18,135
Charlotte,54,"February 11, 2017",L.A.Clippers,1,0,102,107,1,48,102,40,24,6,4,7,20,32,8,37,86,13,37,24,49,15,20,115
Cleveland,54,"February 14, 2017",Minnesota,0,1,116,108,1,48,116,43,27,3,4,10,18,34,9,44,86,13,39,31,47,15,22,134
Boston,54,"February 11, 2017",Utah,0,1,112,104,1,48,112,37,20,6,4,16,24,34,3,42,71,13,30,29,41,15,23,126
Milwaukee,54,"February 13, 2017",Detroit,1,1,102,89,1,48,102,33,26,9,2,11,17,28,5,40,79,6,21,34,58,16,16,122
Houston,54,"February 3, 2017",Chicago,1,1,121,117,1,53,121,48,24,7,3,11,23,40,8,44,98,16,43,28,55,17,25,130
Chicago,54,"February 10, 2017",Phoenix,0,0,97,115,1,48,97,41,20,7,5,11,16,29,12,37,86,5,19,32,67,18,22,106
San Antonio,54,"February 12, 2017",New York,0,0,90,94,1,48,90,46,17,11,1,11,16,25,21,33,91,6,29,27,62,18,22,92
Miami,54,"February 10, 2017",Brooklyn,0,1,108,99,1,48,108,46,16,11,7,14,21,33,13,41,92,7,23,34,69,19,21,121
Denver,54,"February 11, 2017",Cleveland,0,0,109,125,1,48,109,45,23,8,4,12,22,28,17,39,97,12,37,27,60,19,22,116
Indiana,54,"February 11, 2017",Milwaukee,1,0,100,116,1,48,100,36,19,2,6,14,25,28,8,35,73,10,22,25,51,20,24,107
New Orleans,54,"February 10, 2017",Minnesota,0,1,122,106,1,48,122,43,27,8,3,21,23,35,8,45,75,12,25,33,50,20,27,145
Memphis,54,"February 6, 2017",San Antonio,1,1,89,74,1,48,89,50,18,8,11,13,17,35,15,32,81,4,19,28,62,21,25,110
Brooklyn,54,"February 10, 2017",Miami,1,0,99,108,1,48,99,48,19,4,5,22,18,33,15,35,81,8,20,27,61,21,28,100
Washington,54,"February 13, 2017",Oklahoma City,1,1,120,98,1,48,120,40,27,4,9,22,24,34,6,42,73,13,21,29,52,23,28,142
Portland,54,"February 9, 2017",Boston,1,0,111,120,1,48,111,41,23,4,6,15,23,31,10,39,77,9,26,30,51,24,31,125
Atlanta,54,"February 10, 2017",Sacramento,0,0,107,108,1,48,107,37,19,6,5,16,17,34,3,36,71,11,30,25,41,24,31,116
Minnesota,54,"February 10, 2017",New Orleans,1,0,106,122,1,48,106,34,22,11,0,13,21,22,12,38,82,6,27,32,55,24,32,108
L.A. Lakers,54,"February 6, 2017",New York,0,1,121,107,1,48,121,55,19,9,6,7,28,35,20,44,102,8,28,36,74,25,31,139
Golden State,54,"February 11, 2017",Oklahoma City,0,1,130,114,1,48,130,40,28,10,3,11,22,30,10,46,87,13,31,33,56,25,35,149
Philadelphia,54,"February 11, 2017",Miami,1,1,117,109,1,48,117,38,27,15,8,10,21,27,11,39,86,9,25,30,61,30,38,140
New York,55,"February 10, 2017",Denver,1,0,123,131,1,48,123,33,36,10,5,10,14,23,10,52,93,16,38,36,55,3,5,154
L.A. Clippers,55,"February 13, 2017",Utah,0,1,88,72,1,48,88,49,16,7,7,13,19,43,6,36,81,9,25,27,56,7,11,105
Chicago,55,"February 12, 2017",Minnesota,0,0,89,117,1,48,89,35,22,7,2,18,24,26,9,35,84,10,25,25,59,9,13,84
Washington,55,"February 16, 2017",Indiana,0,1,111,98,1,48,111,39,23,5,3,10,19,31,8,43,83,15,29,28,54,10,15,126
Philadelphia,55,"February 13, 2017",Charlotte,0,1,105,99,1,48,105,51,24,9,5,18,21,42,9,41,86,12,33,29,53,11,17,125
Golden State,55,"February 13, 2017",Denver,0,0,110,132,1,48,110,27,25,12,6,9,13,23,4,45,92,8,32,37,60,12,13,123
Denver,55,"February 13, 2017",Golden State,1,1,132,110,1,48,132,52,34,6,2,22,14,38,14,48,88,24,40,24,48,12,16,160
Portland,55,"February 13, 2017",Atlanta,1,0,104,109,1,53,104,66,22,4,4,14,34,44,22,37,103,16,42,21,61,14,25,109
Brooklyn,55,"February 13, 2017",Memphis,1,0,103,112,1,48,103,32,23,8,0,12,24,26,6,38,82,12,37,26,45,15,18,107
Boston,55,"February 13, 2017",Dallas,0,1,111,98,1,48,111,41,28,5,3,12,25,34,7,40,81,16,34,24,47,15,18,132
Cleveland,55,"February 15, 2017",Indiana,1,1,113,104,1,48,113,40,23,6,2,8,19,31,9,39,82,18,39,21,43,17,19,131
Toronto,55,"February 12, 2017",Detroit,1,0,101,102,1,48,101,38,18,4,5,9,18,32,6,38,75,8,16,30,59,17,25,112
New Orleans,55,"February 12, 2017",Sacramento,0,0,99,105,1,48,99,36,23,10,2,17,23,30,6,34,82,13,31,21,51,18,21,102
Orlando,55,"February 9, 2017",Philadelphia,1,0,111,112,1,48,111,47,27,4,8,21,20,40,7,41,84,10,21,31,63,19,24,128
Dallas,55,"February 13, 2017",Boston,1,0,98,111,1,48,98,37,21,7,2,12,16,33,4,35,77,9,27,26,50,19,25,105
Charlotte,55,"February 13, 2017",Philadelphia,1,0,99,105,1,48,99,33,19,11,5,15,17,30,3,34,78,11,31,23,47,20,26,102
Phoenix,55,"February 11, 2017",Houston,0,0,102,133,1,48,102,42,20,8,4,19,28,30,12,37,94,8,22,29,72,20,26,94
Indiana,55,"February 13, 2017",San Antonio,1,0,106,110,1,48,106,37,21,8,3,11,23,31,6,38,78,9,20,29,58,21,30,115
L.A. Lakers,55,"February 8, 2017",Detroit,0,0,102,121,1,48,102,41,21,7,3,21,21,34,7,37,86,6,23,31,63,22,26,100
Detroit,55,"February 12, 2017",Toronto,0,1,102,101,1,48,102,41,12,8,5,7,18,30,11,36,84,8,31,28,53,22,29,106
Milwaukee,55,"February 15, 2017",Brooklyn,0,1,129,125,1,48,129,39,27,16,3,10,19,32,7,50,88,7,15,43,73,22,32,156
Minnesota,55,"February 12, 2017",Chicago,1,1,117,89,1,48,117,46,27,11,4,14,14,36,10,44,81,6,24,38,57,23,26,151
San Antonio,55,"February 13, 2017",Indiana,0,1,110,106,1,48,110,49,18,7,4,11,22,37,12,40,87,7,15,33,72,23,27,126
Sacramento,55,"February 12, 2017",New Orleans,1,1,105,99,1,48,105,46,23,11,5,19,18,38,8,35,78,11,31,24,47,24,27,125
Miami,55,"February 11, 2017",Philadelphia,0,0,109,117,1,48,109,49,15,4,4,19,27,38,11,39,85,7,23,32,62,24,28,112
Houston,55,"February 7, 2017",Orlando,1,1,128,104,1,48,128,42,31,9,2,10,15,32,10,44,89,16,38,28,51,24,36,145
Utah,55,"February 11, 2017",Boston,1,0,104,112,1,48,104,39,16,9,2,9,19,26,13,35,86,8,31,27,55,26,30,106
Memphis,55,"February 8, 2017",Phoenix,1,1,110,91,1,48,110,41,24,6,8,22,25,30,11,35,72,14,24,21,48,26,34,122
Oklahoma City,55,"February 11, 2017",Golden State,1,0,114,130,1,48,114,43,20,7,8,19,23,31,12,40,83,6,24,34,59,28,36,122
Atlanta,55,"February 13, 2017",Portland,0,1,109,104,1,53,109,52,20,9,12,9,23,45,7,32,83,8,28,24,55,37,48,131
Charlotte,56,"February 15, 2017",Toronto,0,0,85,90,1,48,85,44,21,9,6,17,18,39,5,32,76,13,38,19,38,8,9,103
Dallas,56,"February 15, 2017",Detroit,0,0,91,98,1,48,91,38,22,10,2,6,21,33,5,35,91,10,36,25,55,11,11,101
L.A. Clippers,56,"February 15, 2017",Atlanta,1,1,99,84,1,48,99,40,24,18,3,16,17,35,5,37,79,14,37,23,42,11,12,125
Indiana,56,"February 15, 2017",Cleveland,0,0,104,113,1,48,104,43,30,2,1,11,17,30,13,40,86,12,24,28,62,12,14,121
Cleveland,56,"February 23, 2017",New York,1,1,119,104,1,48,119,45,29,5,10,12,16,37,8,46,87,15,38,31,49,12,15,152
Denver,56,"February 15, 2017",Minnesota,1,0,99,112,1,48,99,49,25,4,6,14,19,35,14,38,94,11,34,27,60,12,18,107
Utah,56,"February 13, 2017",L.A.Clippers,1,0,72,88,1,48,72,49,14,5,4,10,11,37,12,28,87,4,23,24,64,12,18,69
Philadelphia,56,"February 15, 2017",Boston,0,0,108,116,1,48,108,47,23,16,5,22,23,35,12,44,93,8,31,36,62,12,18,122
Orlando,56,"February 11, 2017",Dallas,0,0,80,112,1,48,80,40,16,8,5,14,16,29,11,32,82,3,23,29,59,13,18,80
Atlanta,56,"February 15, 2017",L.A.Clippers,0,0,84,99,1,48,84,45,20,5,1,20,13,35,10,32,79,7,26,25,53,13,19,82
Detroit,56,"February 13, 2017",Milwaukee,0,0,89,102,1,48,89,44,17,4,1,17,18,32,12,34,78,7,21,27,57,14,19,89
Golden State,56,"February 15, 2017",Sacramento,1,1,109,86,1,48,109,46,32,10,10,8,16,40,6,41,84,13,36,28,48,14,21,149
San Antonio,56,"February 15, 2017",Orlando,0,1,107,79,1,48,107,50,25,12,8,12,16,39,11,42,89,8,31,34,58,15,19,139
Minnesota,56,"February 14, 2017",Cleveland,1,0,108,116,1,48,108,41,27,6,2,9,18,33,8,42,86,9,23,33,63,15,19,127
Portland,56,"February 15, 2017",Utah,0,0,88,111,1,48,88,41,14,9,3,16,21,32,9,32,79,9,22,23,57,15,20,87
Houston,56,"February 9, 2017",Charlotte,0,1,107,95,1,48,107,41,22,13,5,17,19,33,8,39,86,13,40,26,46,16,20,120
New York,56,"February 12, 2017",San Antonio,1,1,94,90,1,48,94,44,18,5,8,19,19,39,5,34,68,9,14,25,54,17,21,112
Sacramento,56,"February 14, 2017",L.A.Lakers,0,1,97,96,1,48,97,39,23,9,3,17,12,31,8,36,73,7,24,29,49,18,25,110
Brooklyn,56,"February 15, 2017",Milwaukee,1,0,125,129,1,48,125,42,30,7,8,17,21,33,9,46,88,14,36,32,52,19,23,149
Toronto,56,"February 14, 2017",Chicago,0,0,94,105,1,48,94,34,15,9,1,16,26,26,8,35,77,5,20,30,57,19,24,90
Phoenix,56,"February 13, 2017",New Orleans,1,0,108,110,1,48,108,43,14,7,3,18,25,30,13,40,93,8,23,32,70,20,24,100
Miami,56,"February 13, 2017",Orlando,1,0,107,116,1,48,107,37,14,7,7,14,25,31,6,39,83,6,22,33,61,23,27,110
Oklahoma City,56,"February 13, 2017",Washington,0,0,98,120,1,48,98,47,16,10,3,15,22,27,20,34,96,7,34,27,62,23,30,90
Milwaukee,56,"February 24, 2017",Utah,1,0,95,109,1,48,95,35,15,5,2,15,27,25,10,32,74,7,18,25,56,24,29,90
Boston,56,"February 15, 2017",Philadelphia,1,1,116,108,1,48,116,39,21,13,4,22,18,33,6,38,80,13,28,25,52,27,36,120
Chicago,56,"February 14, 2017",Toronto,1,1,105,94,1,48,105,37,22,8,5,17,23,30,7,35,73,7,17,28,56,28,35,115
New Orleans,56,"February 13, 2017",Phoenix,0,1,110,108,1,48,110,37,19,8,5,16,23,32,5,37,78,8,28,29,50,28,35,115
L.A. Lakers,56,"February 10, 2017",Milwaukee,0,1,122,114,1,48,122,33,25,9,3,17,24,27,6,39,75,15,30,24,45,29,35,133
Memphis,56,"February 10, 2017",Golden State,1,0,107,122,1,48,107,47,20,6,4,18,28,29,18,34,87,9,26,25,61,30,37,106
Washington,56,"February 24, 2017",Philadelphia,0,0,112,120,1,48,112,43,19,8,5,16,25,31,12,38,90,5,24,33,66,31,40,110
Dallas,57,"February 24, 2017",Minnesota,0,0,84,97,1,48,84,35,16,9,5,15,19,27,8,35,83,8,33,27,50,6,9,83
L.A. Lakers,57,"February 14, 2017",Sacramento,1,0,96,97,1,48,96,42,22,10,3,17,21,29,13,38,83,12,29,26,54,8,15,104
Washington,57,"February 26, 2017",Utah,1,0,92,102,1,48,92,27,21,16,1,15,27,21,6,37,87,8,22,29,65,10,13,89
Denver,57,"February 23, 2017",Sacramento,0,0,100,116,1,48,100,42,23,10,2,15,18,33,9,39,88,12,35,27,53,10,14,109
Cleveland,57,"February 25, 2017",Chicago,1,0,99,117,1,48,99,40,24,5,3,12,17,36,4,37,80,14,37,23,43,11,15,112
New York,57,"February 15, 2017",Oklahoma City,0,0,105,116,1,48,105,39,19,8,12,15,21,33,6,41,86,11,21,30,65,12,14,121
Sacramento,57,"February 15, 2017",Golden State,0,0,86,109,1,48,86,50,23,4,6,18,17,38,12,33,89,7,24,26,65,13,17,91
New Orleans,57,"February 15, 2017",Memphis,0,1,95,91,1,48,95,38,18,10,5,12,23,34,4,37,75,8,18,29,57,13,22,107
Indiana,57,"February 16, 2017",Washington,1,0,98,111,1,48,98,35,21,7,1,10,12,30,5,40,81,4,18,36,63,14,18,107
Toronto,57,"February 15, 2017",Charlotte,1,1,90,85,1,48,90,46,19,8,4,14,13,38,8,32,84,12,32,20,52,14,19,96
Milwaukee,57,"February 26, 2017",Phoenix,1,1,100,96,1,48,100,33,26,10,6,19,21,27,6,39,76,6,20,33,56,16,18,117
Utah,57,"February 15, 2017",Portland,1,1,111,88,1,48,111,46,19,9,5,14,17,37,9,42,81,11,22,31,59,16,23,130
Miami,57,"February 15, 2017",Houston,0,1,117,109,1,48,117,46,27,3,7,11,20,34,12,44,84,13,35,31,49,16,24,141
Boston,57,"February 16, 2017",Chicago,0,0,103,104,1,48,103,31,24,2,4,7,18,27,4,36,77,14,37,22,40,17,20,113
Brooklyn,57,"February 24, 2017",Denver,0,0,109,129,1,48,109,42,27,7,4,19,23,35,7,41,83,10,30,31,53,17,31,114
Detroit,57,"February 15, 2017",Dallas,1,1,98,91,1,48,98,57,15,2,4,15,16,46,11,36,83,6,20,30,63,20,22,112
Orlando,57,"February 13, 2017",Miami,0,1,116,107,1,48,116,52,18,9,3,14,22,37,15,44,90,8,14,36,76,20,29,129
Portland,57,"February 23, 2017",Orlando,0,1,112,103,1,48,112,45,20,8,7,19,25,36,9,41,81,9,19,32,62,21,27,127
Chicago,57,"February 16, 2017",Boston,1,1,104,103,1,48,104,51,23,2,6,7,13,36,15,38,90,6,25,32,65,22,22,127
Oklahoma City,57,"February 15, 2017",New York,1,1,116,105,1,48,116,48,21,10,4,12,13,36,12,41,88,12,23,29,65,22,31,131
Golden State,57,"February 23, 2017",L.A.Clippers,1,1,123,113,1,48,123,53,31,11,11,21,27,43,10,43,81,13,26,30,55,24,26,168
Minnesota,57,"February 15, 2017",Denver,0,1,112,99,1,48,112,45,20,12,4,7,15,36,9,41,86,6,18,35,68,24,28,137
Philadelphia,57,"February 24, 2017",Washington,1,1,120,112,1,48,120,48,28,9,7,15,26,40,8,43,87,10,29,33,58,24,30,147
Atlanta,57,"February 24, 2017",Miami,1,0,90,108,1,48,90,45,14,7,7,10,12,37,8,30,79,6,20,24,59,24,36,92
Charlotte,57,"February 23, 2017",Detroit,0,0,108,114,1,53,108,50,19,5,7,7,15,45,5,38,92,7,30,31,62,25,26,127
Memphis,57,"February 13, 2017",Brooklyn,0,1,112,103,1,48,112,41,25,7,1,12,16,36,5,39,77,9,22,30,55,25,27,134
San Antonio,57,"February 24, 2017",L.A.Clippers,0,1,105,97,1,48,105,51,23,9,7,12,21,36,15,35,82,9,26,26,56,26,30,132
L.A. Clippers,57,"February 23, 2017",Golden State,0,0,113,123,1,48,113,38,23,11,0,14,16,28,10,38,93,11,28,27,65,26,37,105
Phoenix,57,"February 15, 2017",L.A.Lakers,1,1,137,101,1,48,137,59,32,7,10,15,20,47,12,49,88,10,24,39,64,29,34,186
Houston,57,"February 11, 2017",Phoenix,1,1,133,102,1,48,133,55,27,8,4,21,23,39,16,42,85,18,36,24,49,31,39,155
Minnesota,58,"February 24, 2017",Dallas,1,1,97,84,1,48,97,44,24,9,4,16,12,35,9,41,78,5,13,36,65,10,14,121
Milwaukee,58,"February 27, 2017",Cleveland,0,0,95,102,1,48,95,33,27,3,5,8,23,28,5,37,83,11,29,26,54,10,16,103
Indiana,58,"February 24, 2017",Memphis,1,1,102,92,1,48,102,50,23,8,7,16,19,42,8,40,78,11,26,29,52,11,11,136
Detroit,58,"February 23, 2017",Charlotte,1,1,114,108,1,53,114,57,29,5,2,8,17,47,10,44,107,15,37,29,70,11,12,135
San Antonio,58,"February 26, 2017",L.A.Lakers,0,1,119,98,1,48,119,46,37,12,5,12,15,33,13,49,94,10,21,39,73,11,13,160
Miami,58,"February 24, 2017",Atlanta,0,1,108,90,1,48,108,54,30,7,5,12,27,39,15,40,99,17,37,23,62,11,13,131
Brooklyn,58,"February 25, 2017",Golden State,0,0,95,112,1,48,95,52,25,8,3,16,20,41,11,38,94,8,28,30,66,11,17,105
Dallas,58,"February 25, 2017",New Orleans,1,1,96,83,1,48,96,43,24,12,4,17,25,36,7,36,78,12,26,24,52,12,16,116
New York,58,"February 23, 2017",Cleveland,0,0,104,119,1,48,104,49,24,4,7,12,19,34,15,42,100,8,26,34,74,12,17,113
Oklahoma City,58,"February 24, 2017",L.A.Lakers,1,1,110,93,1,48,110,59,28,9,7,17,14,45,14,44,97,10,24,34,73,12,17,138
Atlanta,58,"February 25, 2017",Orlando,0,0,86,105,1,48,86,48,21,4,4,17,19,36,12,32,84,8,25,24,59,14,26,82
Orlando,58,"February 15, 2017",San Antonio,1,0,79,107,1,48,79,33,15,5,5,17,19,28,5,30,76,4,18,26,58,15,19,70
Phoenix,58,"February 24, 2017",Chicago,0,0,121,128,1,53,121,43,27,8,6,19,23,35,8,49,93,8,24,41,69,15,25,132
Charlotte,58,"February 25, 2017",Sacramento,0,1,99,85,1,48,99,50,26,10,3,10,13,37,13,34,85,14,38,20,47,17,18,126
Sacramento,58,"February 23, 2017",Denver,1,1,116,100,1,48,116,47,26,7,4,14,16,38,9,46,88,7,14,39,74,17,19,142
Golden State,58,"February 25, 2017",Brooklyn,1,1,112,95,1,48,112,52,30,10,11,11,17,39,13,42,100,11,31,31,69,17,22,141
Denver,58,"February 24, 2017",Brooklyn,1,1,129,109,1,48,129,51,32,11,2,13,24,40,11,49,97,14,31,35,66,17,24,157
Washington,58,"February 28, 2017",Golden State,1,1,112,108,1,48,112,46,29,11,6,19,22,29,17,41,91,12,28,29,63,18,20,133
Boston,58,"February 24, 2017",Toronto,0,0,97,107,1,48,97,36,19,4,3,11,21,29,7,33,78,12,38,21,40,19,22,100
Memphis,58,"February 15, 2017",New Orleans,1,0,91,95,1,48,91,48,22,8,3,15,19,35,13,33,89,6,33,27,56,19,25,95
L.A. Clippers,58,"February 24, 2017",San Antonio,1,0,97,105,1,48,97,36,18,9,2,12,26,28,8,35,79,7,23,28,56,20,24,102
New Orleans,58,"February 23, 2017",Houston,1,0,99,129,1,48,99,45,24,10,8,20,21,33,12,36,86,6,31,30,55,21,26,111
Cleveland,58,"February 27, 2017",Milwaukee,1,1,102,95,1,48,102,45,20,4,2,16,11,41,4,35,70,10,27,25,43,22,26,118
Philadelphia,58,"February 25, 2017",New York,0,0,109,110,1,48,109,50,19,6,5,11,21,34,16,40,95,7,31,33,64,22,27,118
L.A. Lakers,58,"February 15, 2017",Phoenix,0,0,101,137,1,48,101,36,16,9,3,12,27,29,7,35,93,9,26,26,67,22,28,89
Toronto,58,"February 24, 2017",Boston,1,1,107,97,1,48,107,41,15,7,5,9,21,31,10,40,81,5,15,35,66,22,29,118
Chicago,58,"February 24, 2017",Phoenix,1,1,128,121,1,53,128,46,31,15,4,12,21,35,11,46,98,12,26,34,72,24,31,153
Houston,58,"February 15, 2017",Miami,1,0,109,117,1,48,109,41,22,6,1,8,23,26,15,36,87,13,40,23,47,24,31,113
Utah,58,"February 24, 2017",Milwaukee,0,1,109,95,1,48,109,42,23,8,5,14,26,32,10,37,74,8,23,29,51,27,30,133
Portland,58,"February 26, 2017",Toronto,0,0,106,112,1,48,106,39,16,6,5,9,26,31,8,35,79,9,21,26,58,27,35,111
L.A. Lakers,59,"February 24, 2017",Oklahoma City,0,0,93,110,1,48,93,51,23,15,8,13,19,36,15,40,101,7,35,33,66,6,14,108
Chicago,59,"February 25, 2017",Cleveland,0,1,117,99,1,48,117,47,34,6,0,7,13,37,10,46,93,15,30,31,63,10,16,144
Phoenix,59,"February 26, 2017",Milwaukee,0,0,96,100,1,48,96,42,26,12,5,20,22,30,12,40,83,5,14,35,69,11,16,113
Sacramento,59,"February 25, 2017",Charlotte,1,0,85,99,1,48,85,41,18,3,6,14,19,32,9,31,79,11,28,20,51,12,15,88
Milwaukee,59,"March 1, 2017",Denver,1,0,98,110,1,48,98,34,26,8,5,13,19,24,10,38,83,9,18,29,65,13,15,111
Denver,59,"February 26, 2017",Memphis,1,0,98,105,1,48,98,39,26,9,3,12,23,29,10,37,84,11,34,26,50,13,17,112
Memphis,59,"February 24, 2017",Indiana,0,0,92,102,1,48,92,39,20,11,5,11,15,27,12,35,84,9,27,26,57,13,23,97
Cleveland,59,"March 1, 2017",Boston,0,0,99,103,1,48,99,41,20,3,5,10,21,29,12,37,91,10,33,27,58,15,22,97
Portland,59,"February 28, 2017",Detroit,0,0,113,120,1,53,113,50,25,5,5,24,25,42,8,44,84,10,25,34,59,15,22,127
Washington,59,"March 1, 2017",Toronto,0,1,105,96,1,48,105,44,32,6,7,12,21,37,7,40,84,9,25,31,59,16,19,135
Atlanta,59,"February 27, 2017",Boston,0,1,114,98,1,48,114,55,22,10,10,14,19,42,13,46,95,6,25,40,70,16,20,144
New Orleans,59,"February 25, 2017",Dallas,0,0,83,96,1,48,83,45,21,7,2,19,19,36,9,31,78,5,24,26,54,16,25,83
Detroit,59,"February 26, 2017",Boston,1,0,98,104,1,48,98,45,22,8,4,17,24,34,11,35,81,12,33,23,48,16,35,95
New York,59,"February 25, 2017",Philadelphia,1,1,110,109,1,48,110,44,21,6,7,11,22,34,10,43,91,6,21,37,70,18,23,124
Houston,59,"February 23, 2017",New Orleans,0,1,129,99,1,48,129,48,28,12,5,16,25,36,12,45,91,20,51,25,40,19,24,155
Dallas,59,"February 27, 2017",Miami,1,1,96,89,1,48,96,42,18,5,2,13,13,31,11,33,76,9,18,24,58,21,23,105
San Antonio,59,"March 1, 2017",Indiana,1,1,100,99,1,48,100,36,20,8,7,18,21,30,6,35,74,9,29,26,45,21,24,111
Toronto,59,"February 26, 2017",Portland,1,1,112,106,1,48,112,39,16,7,6,10,24,34,5,42,78,7,20,35,58,21,27,128
Indiana,59,"February 25, 2017",Miami,0,0,95,113,1,48,95,43,21,8,4,15,24,30,13,34,85,4,12,30,73,23,26,102
Minnesota,59,"February 25, 2017",Houston,0,0,130,142,1,48,130,58,28,10,2,23,26,37,21,49,94,9,26,40,68,23,28,155
Utah,59,"February 26, 2017",Washington,0,1,102,92,1,48,102,52,18,9,11,24,19,41,11,34,73,11,24,23,49,23,32,120
Philadelphia,59,"February 27, 2017",Golden State,1,0,108,119,1,48,108,41,24,11,3,22,25,30,11,37,81,10,34,27,47,24,27,118
Boston,59,"February 26, 2017",Detroit,0,1,104,98,1,48,104,52,22,9,1,14,26,43,9,34,85,12,35,22,50,24,30,117
Miami,59,"February 25, 2017",Indiana,1,1,113,95,1,48,113,43,23,9,5,16,19,32,11,38,78,13,31,25,47,24,31,130
L.A. Clippers,59,"February 26, 2017",Charlotte,1,1,124,121,1,53,124,47,27,14,3,9,25,32,15,45,97,10,32,35,65,24,34,144
Charlotte,59,"February 26, 2017",L.A.Clippers,0,0,121,124,1,53,121,43,16,1,1,16,32,38,5,38,80,18,40,20,40,27,30,121
Oklahoma City,59,"February 26, 2017",New Orleans,1,1,118,110,1,48,118,53,17,4,0,13,29,37,16,42,88,6,21,36,67,28,37,124
Orlando,59,"February 23, 2017",Portland,1,0,103,112,1,48,103,40,18,8,4,14,21,27,13,34,86,7,22,27,64,28,39,96
Brooklyn,59,"March 1, 2017",Sacramento,0,1,109,100,1,48,109,43,16,8,2,18,25,33,10,34,74,11,28,23,46,30,36,114
Golden State,59,"February 27, 2017",Philadelphia,0,1,119,108,1,48,119,45,31,14,4,13,18,29,16,40,89,6,29,34,60,33,39,145
Miami,60,"February 27, 2017",Dallas,0,0,89,96,1,48,89,45,21,12,4,13,18,32,13,37,83,9,26,28,57,6,13,105
L.A. Clippers,60,"March 1, 2017",Houston,1,0,103,122,1,48,103,36,26,8,3,7,23,26,10,42,94,12,34,30,60,7,13,111
Chicago,60,"February 28, 2017",Denver,1,0,107,125,1,48,107,35,26,10,3,12,19,24,11,44,96,10,26,34,70,9,10,116
Sacramento,60,"February 27, 2017",Minnesota,1,0,88,102,1,48,88,42,23,6,4,18,18,35,7,36,82,6,17,30,65,10,15,94
Utah,60,"February 28, 2017",Oklahoma City,0,0,106,109,1,48,106,33,22,8,4,7,18,25,8,43,93,9,22,34,71,11,13,114
Dallas,60,"March 1, 2017",Atlanta,0,0,95,100,1,48,95,33,22,10,5,20,20,23,10,35,77,14,33,21,44,11,13,101
L.A. Lakers,60,"February 26, 2017",San Antonio,1,0,98,119,1,48,98,44,16,8,2,18,18,31,13,40,87,7,22,33,65,11,18,96
Milwaukee,60,"March 3, 2017",L.A.Clippers,1,1,112,101,1,48,112,25,35,11,4,10,27,22,3,44,80,10,25,34,55,14,15,140
Minnesota,60,"February 27, 2017",Sacramento,0,1,102,88,1,48,102,52,25,11,7,10,15,36,16,40,95,8,23,32,72,14,20,126
San Antonio,60,"March 3, 2017",New Orleans,0,1,101,98,1,53,101,53,20,6,5,11,22,42,11,40,95,6,27,34,68,15,25,109
New York,60,"February 27, 2017",Toronto,1,0,91,92,1,48,91,40,17,10,6,17,19,32,8,33,73,9,24,24,49,16,19,104
Cleveland,60,"March 3, 2017",Atlanta,0,1,135,130,1,48,135,33,31,7,5,14,24,28,5,47,86,25,46,22,40,16,20,154
Oklahoma City,60,"February 28, 2017",Utah,1,1,109,106,1,48,109,42,20,5,7,14,17,36,6,39,76,15,22,24,54,16,23,125
Charlotte,60,"February 28, 2017",L.A.Lakers,0,1,109,104,1,48,109,46,25,3,6,12,11,34,12,38,85,16,39,22,46,17,24,123
Philadelphia,60,"March 1, 2017",Miami,0,0,98,125,1,48,98,40,16,7,4,19,22,30,10,37,85,6,17,31,68,18,22,94
Brooklyn,60,"March 3, 2017",Utah,0,0,97,112,1,48,97,42,12,6,3,12,24,33,9,36,89,7,29,29,60,18,24,89
Atlanta,60,"March 1, 2017",Dallas,1,1,100,95,1,48,100,34,24,12,4,22,19,30,4,36,64,10,21,26,43,18,24,118
Toronto,60,"February 27, 2017",New York,0,1,92,91,1,48,92,41,12,9,3,12,18,30,11,33,78,7,26,26,52,19,23,96
Phoenix,60,"February 28, 2017",Memphis,0,0,112,130,1,48,112,32,22,6,6,12,25,24,8,43,83,7,21,36,62,19,24,121
Boston,60,"February 27, 2017",Atlanta,1,0,98,114,1,48,98,40,21,9,7,18,20,31,9,34,87,10,34,24,53,20,25,99
Denver,60,"February 28, 2017",Chicago,0,1,125,107,1,48,125,45,26,6,3,16,16,39,6,45,80,13,30,32,50,22,24,152
Memphis,60,"February 26, 2017",Denver,0,1,105,98,1,48,105,49,21,9,2,15,20,36,13,36,80,11,33,25,47,22,25,124
Indiana,60,"February 27, 2017",Houston,0,1,117,108,1,48,117,55,29,7,4,15,26,42,13,41,91,13,30,28,61,22,25,144
Golden State,60,"February 28, 2017",Washington,0,0,108,112,1,48,108,41,28,10,6,19,23,28,13,39,83,8,28,31,55,22,27,125
Orlando,60,"February 25, 2017",Atlanta,1,1,105,86,1,48,105,47,21,11,8,13,23,40,7,37,81,8,27,29,54,23,24,134
Detroit,60,"February 28, 2017",Portland,1,1,120,113,1,53,120,48,23,13,2,7,19,32,16,45,104,7,25,38,79,23,31,132
Portland,60,"March 2, 2017",Oklahoma City,1,1,114,109,1,48,114,45,19,9,7,14,19,36,9,39,79,10,25,29,54,26,35,131
Washington,60,"March 3, 2017",Toronto,1,0,106,114,1,48,106,45,23,8,6,11,21,30,15,34,92,10,30,24,62,28,32,115
New Orleans,60,"February 26, 2017",Oklahoma City,0,0,110,118,1,48,110,35,17,10,1,10,26,28,7,36,80,8,21,28,59,30,37,112
Houston,60,"February 25, 2017",Minnesota,1,1,142,130,1,48,142,31,32,15,7,13,21,19,12,44,94,22,58,22,36,32,42,154
Detroit,61,"March 1, 2017",New Orleans,0,0,86,109,1,48,86,50,13,11,3,7,17,27,23,40,103,3,23,37,80,3,17,79
Utah,61,"March 1, 2017",Minnesota,1,0,80,107,1,48,80,46,18,6,5,14,23,30,16,35,90,4,19,31,71,6,11,81
L.A. Lakers,61,"February 28, 2017",Charlotte,1,0,104,109,1,48,104,39,22,9,5,14,23,33,6,41,84,12,32,29,52,10,13,119
Cleveland,61,"March 4, 2017",Miami,0,0,92,120,1,48,92,33,20,4,1,15,16,25,8,35,73,11,27,24,46,11,18,90
Brooklyn,61,"March 4, 2017",Portland,0,0,116,130,1,48,116,31,24,7,6,13,22,23,8,45,86,14,30,31,56,12,17,125
Golden State,61,"March 2, 2017",Chicago,0,0,87,94,1,48,87,41,23,10,6,15,18,35,6,34,88,6,30,28,58,13,14,97
Miami,61,"March 1, 2017",Philadelphia,1,1,125,98,1,48,125,42,24,9,12,13,18,34,8,49,90,13,30,36,60,14,21,151
San Antonio,61,"March 4, 2017",Minnesota,1,1,97,90,1,53,97,49,16,10,8,12,17,32,17,38,94,6,24,32,70,15,24,103
Portland,61,"March 4, 2017",Brooklyn,1,1,130,116,1,48,130,37,29,9,6,12,13,31,6,49,86,16,25,33,61,16,22,156
Chicago,61,"March 2, 2017",Golden State,1,1,94,87,1,48,94,49,19,9,5,15,15,42,7,36,82,5,19,31,63,17,21,111
Orlando,61,"March 1, 2017",New York,1,0,90,101,1,48,90,43,11,3,3,12,25,34,9,34,83,5,25,29,58,17,22,84
Denver,61,"March 1, 2017",Milwaukee,0,1,110,98,1,48,110,45,21,8,3,14,15,31,14,41,84,10,33,31,51,18,20,128
Boston,61,"March 1, 2017",Cleveland,1,1,103,99,1,48,103,47,28,4,6,12,21,39,8,36,78,13,31,23,47,18,23,129
Indiana,61,"March 1, 2017",San Antonio,0,0,99,100,1,48,99,41,22,13,1,17,26,28,13,37,81,7,24,30,57,18,25,108
Sacramento,61,"March 1, 2017",Brooklyn,1,0,100,109,1,48,100,38,12,8,3,15,28,28,10,35,81,11,22,24,59,19,22,97
Milwaukee,61,"March 4, 2017",Toronto,1,1,101,94,1,48,101,42,16,3,4,6,18,33,9,38,87,6,27,32,60,19,23,107
Phoenix,61,"March 2, 2017",Charlotte,1,1,120,103,1,48,120,42,30,8,7,18,23,38,4,46,77,7,19,39,58,21,25,154
Minnesota,61,"March 1, 2017",Utah,0,1,107,80,1,48,107,48,23,11,7,10,15,38,10,39,78,8,16,31,62,21,26,142
Dallas,61,"March 3, 2017",Memphis,1,1,104,100,1,48,104,45,23,5,3,8,20,37,8,39,82,5,27,34,55,21,27,123
L.A. Clippers,61,"March 3, 2017",Milwaukee,0,0,101,112,1,48,101,38,23,4,1,23,18,31,7,36,64,8,19,28,45,21,36,101
New Orleans,61,"March 1, 2017",Detroit,1,1,109,86,1,48,109,53,18,6,4,14,15,45,8,39,78,9,25,30,53,22,23,136
Memphis,61,"February 28, 2017",Phoenix,1,1,130,112,1,48,130,39,24,6,3,10,19,27,12,48,86,12,25,36,61,22,29,147
Atlanta,61,"March 3, 2017",Cleveland,1,0,130,135,1,48,130,43,30,7,4,12,15,32,11,49,91,10,26,39,65,22,30,152
Washington,61,"March 5, 2017",Orlando,1,1,115,114,1,48,115,38,26,9,6,12,16,28,10,39,81,14,26,25,55,23,25,138
Toronto,61,"March 1, 2017",Washington,1,0,96,105,1,48,96,50,11,8,3,11,18,34,16,33,90,7,20,26,70,23,26,97
Charlotte,61,"March 2, 2017",Phoenix,0,0,103,120,1,48,103,34,19,14,1,16,20,25,9,35,89,10,34,25,55,23,28,96
Philadelphia,61,"March 3, 2017",New York,1,1,105,102,1,48,105,50,20,5,9,16,21,38,12,36,82,9,28,27,54,24,31,120
New York,61,"March 1, 2017",Orlando,0,1,101,90,1,48,101,50,21,9,3,11,16,37,13,34,81,8,29,26,52,25,31,120
Oklahoma City,61,"March 2, 2017",Portland,0,0,109,114,1,48,109,40,11,9,7,12,25,28,12,34,86,11,29,23,57,30,32,110
Houston,61,"February 27, 2017",Indiana,1,0,108,117,1,48,108,39,22,8,5,10,22,27,12,32,88,10,45,22,43,34,42,108
Philadelphia,62,"March 4, 2017",Detroit,1,0,106,136,1,48,106,36,30,5,2,19,18,30,6,43,88,14,34,29,54,6,7,114
Indiana,62,"March 5, 2017",Atlanta,0,1,97,96,1,48,97,44,24,6,4,15,22,35,9,35,78,15,33,20,45,12,21,108
L.A. Clippers,62,"March 4, 2017",Chicago,0,1,101,91,1,48,101,37,20,7,5,14,17,26,11,41,85,6,25,35,60,13,16,109
Dallas,62,"March 5, 2017",Oklahoma City,1,1,104,89,1,48,104,38,24,6,2,8,20,33,5,42,86,7,25,35,61,13,16,119
Charlotte,62,"March 4, 2017",Denver,0,1,112,102,1,48,112,43,25,8,6,5,18,30,13,41,90,16,27,25,63,14,17,137
Orlando,62,"March 3, 2017",Miami,1,1,110,99,1,48,110,47,27,7,6,9,13,39,8,45,90,5,17,40,73,15,19,139
Chicago,62,"March 4, 2017",L.A.Clippers,1,0,91,101,1,48,91,45,26,11,0,19,24,31,14,35,83,6,17,29,66,15,20,101
L.A. Lakers,62,"March 3, 2017",Boston,1,0,95,115,1,48,95,34,23,11,7,14,21,28,6,37,87,6,24,31,63,15,20,101
Sacramento,62,"March 5, 2017",Utah,1,0,109,110,1,53,109,37,24,8,3,12,21,32,5,43,83,8,17,35,66,15,20,124
Memphis,62,"March 3, 2017",Dallas,0,0,100,104,1,48,100,39,16,4,0,10,23,32,7,38,82,9,28,29,54,15,22,98
Milwaukee,62,"March 6, 2017",Philadelphia,0,1,112,98,1,48,112,41,28,7,7,12,16,32,9,41,83,14,33,27,50,16,20,137
Minnesota,62,"March 4, 2017",San Antonio,0,0,90,97,1,53,90,55,24,6,3,14,20,39,16,35,89,4,16,31,73,16,22,104
Detroit,62,"March 4, 2017",Philadelphia,0,1,136,106,1,48,136,44,26,11,10,7,9,34,10,54,95,10,23,44,72,18,21,176
Golden State,62,"March 5, 2017",New York,0,1,112,105,1,48,112,35,21,11,3,8,18,24,11,40,88,13,35,27,53,19,23,122
Boston,62,"March 3, 2017",L.A.Lakers,0,1,115,95,1,48,115,46,30,7,2,18,17,40,6,43,84,10,33,33,51,19,25,135
Cleveland,62,"March 6, 2017",Miami,1,0,98,106,1,48,98,52,15,3,6,17,15,41,11,35,78,9,27,26,51,19,29,104
Atlanta,62,"March 5, 2017",Indiana,1,0,96,97,1,48,96,44,21,12,1,14,19,33,11,34,77,9,27,25,50,19,31,105
New Orleans,62,"March 3, 2017",San Antonio,1,0,98,101,1,53,98,48,20,2,2,16,22,40,8,35,91,8,25,27,66,20,24,94
San Antonio,62,"March 6, 2017",Houston,1,1,112,110,1,48,112,45,24,6,6,9,13,36,9,40,87,11,27,29,60,21,23,135
Miami,62,"March 3, 2017",Orlando,0,0,99,110,1,48,99,46,20,7,5,9,16,33,13,35,91,8,28,27,63,21,25,108
Denver,62,"March 4, 2017",Charlotte,1,0,102,112,1,48,102,45,21,5,3,13,20,34,11,36,80,9,30,27,50,21,25,115
Portland,62,"March 7, 2017",Oklahoma City,0,1,126,121,1,48,126,36,24,7,5,11,23,24,12,47,85,11,23,36,62,21,27,143
Toronto,62,"March 3, 2017",Washington,0,1,114,106,1,48,114,51,16,5,9,17,23,40,11,41,81,11,25,30,56,21,27,132
Utah,62,"March 3, 2017",Brooklyn,1,1,112,97,1,48,112,45,25,7,5,13,25,40,5,38,74,12,26,26,48,24,34,135
Phoenix,62,"March 3, 2017",Oklahoma City,1,1,118,111,1,48,118,45,28,10,7,17,26,36,9,44,89,5,21,39,68,25,31,140
Houston,62,"March 1, 2017",L.A.Clippers,0,1,122,103,1,48,122,62,21,3,2,16,17,43,19,37,87,20,52,17,35,28,33,139
Oklahoma City,62,"March 3, 2017",Phoenix,0,0,111,118,1,48,111,47,14,10,5,19,30,36,11,37,87,9,35,28,52,28,35,111
New York,62,"March 3, 2017",Philadelphia,0,0,102,105,1,48,102,40,14,11,2,10,20,31,9,33,84,7,21,26,63,29,33,104
Brooklyn,62,"March 6, 2017",Memphis,0,1,122,109,1,48,122,41,16,12,5,16,27,34,7,39,73,14,30,25,43,30,38,138
Washington,62,"March 7, 2017",Phoenix,0,1,131,127,1,48,131,44,19,15,4,11,21,35,9,41,90,7,18,34,72,42,53,142
Indiana,63,"March 6, 2017",Charlotte,0,0,88,100,1,48,88,41,29,3,5,15,17,35,6,37,81,12,30,25,51,2,3,106
Miami,63,"March 4, 2017",Cleveland,1,1,120,92,1,48,120,48,20,6,4,10,19,33,15,46,88,18,34,28,54,10,12,144
L.A. Lakers,63,"March 5, 2017",New Orleans,1,0,97,105,1,48,97,49,22,7,5,25,24,38,11,38,83,10,28,28,55,11,15,106
Cleveland,63,"March 9, 2017",Detroit,0,0,101,106,1,48,101,41,24,5,0,9,17,33,8,39,84,11,39,28,45,12,19,110
Philadelphia,63,"March 6, 2017",Milwaukee,1,0,98,112,1,48,98,42,30,5,3,12,20,28,14,39,89,8,30,31,59,12,19,109
Washington,63,"March 8, 2017",Denver,0,1,123,113,1,48,123,43,31,10,0,11,16,35,8,50,88,11,26,39,62,12,19,151
Orlando,63,"March 5, 2017",Washington,0,0,114,115,1,48,114,43,16,9,3,14,18,30,13,44,89,14,35,30,54,12,19,119
Detroit,63,"March 6, 2017",Chicago,1,1,109,95,1,48,109,48,26,7,3,6,19,38,10,45,92,6,21,39,71,13,20,133
Memphis,63,"March 4, 2017",Houston,0,0,108,123,1,48,108,46,26,8,6,13,24,29,17,43,97,8,28,35,69,14,21,120
Dallas,63,"March 7, 2017",L.A.Lakers,1,1,122,111,1,48,122,41,25,5,5,14,17,35,6,45,83,17,31,28,52,15,19,142
San Antonio,63,"March 8, 2017",Sacramento,1,1,114,104,1,48,114,43,33,9,5,12,15,37,6,42,84,14,29,28,55,16,21,145
Toronto,63,"March 4, 2017",Milwaukee,0,0,94,101,1,48,94,36,20,2,4,11,23,33,3,35,75,7,21,28,54,17,20,102
Golden State,63,"March 6, 2017",Atlanta,0,1,119,111,1,48,119,43,33,10,4,14,22,30,13,41,87,20,44,21,43,17,22,144
Minnesota,63,"March 8, 2017",L.A.Clippers,1,1,107,91,1,48,107,50,26,10,4,12,23,36,14,42,86,5,20,37,66,18,20,139
Sacramento,63,"March 6, 2017",Denver,0,0,96,108,1,48,96,40,20,9,1,15,18,29,11,36,83,6,16,30,67,18,21,101
Utah,63,"March 5, 2017",Sacramento,0,1,110,109,1,53,110,47,24,8,3,13,15,35,12,41,90,10,33,31,57,18,27,121
Charlotte,63,"March 6, 2017",Indiana,1,1,100,88,1,48,100,50,21,10,2,10,8,37,13,35,86,11,31,24,55,19,21,120
Chicago,63,"March 6, 2017",Detroit,0,0,95,109,1,48,95,37,21,3,5,10,20,30,7,34,83,8,28,26,55,19,21,100
Brooklyn,63,"March 8, 2017",Atlanta,0,0,105,110,1,48,105,40,28,7,11,22,25,35,5,37,80,11,34,26,46,20,25,121
New York,63,"March 5, 2017",Golden State,1,0,105,112,1,48,105,47,18,5,6,15,20,35,12,39,83,7,22,32,61,20,25,117
Phoenix,63,"March 5, 2017",Boston,1,1,109,106,1,48,109,50,16,7,10,11,29,40,10,42,94,4,20,38,74,21,26,124
Denver,63,"March 6, 2017",Sacramento,1,1,108,96,1,48,108,41,28,11,2,17,18,33,8,37,75,13,30,24,45,21,28,128
Oklahoma City,63,"March 5, 2017",Dallas,0,0,89,104,1,48,89,49,19,4,2,15,21,36,13,33,82,2,22,31,60,21,30,90
Milwaukee,63,"March 8, 2017",New York,1,1,104,93,1,48,104,46,26,9,4,8,13,34,12,37,86,8,26,29,60,22,28,126
Atlanta,63,"March 6, 2017",Golden State,1,0,111,119,1,48,111,47,19,6,6,19,23,33,14,38,82,13,28,25,54,22,31,117
New Orleans,63,"March 5, 2017",L.A.Lakers,0,1,105,97,1,48,105,44,23,12,5,13,12,31,13,36,89,9,24,27,65,24,35,112
Houston,63,"March 4, 2017",Memphis,1,1,123,108,1,48,123,43,25,10,4,14,20,33,10,39,78,18,42,21,36,27,36,143
Portland,63,"March 9, 2017",Philadelphia,1,1,114,108,1,53,114,55,25,8,12,19,22,39,16,40,88,6,21,34,67,28,33,142
Boston,63,"March 5, 2017",Phoenix,0,0,106,109,1,48,106,54,19,6,6,12,28,40,14,32,85,13,37,19,48,29,40,115
L.A. Clippers,63,"March 6, 2017",Boston,1,1,116,102,1,48,116,47,23,7,5,13,24,39,8,39,73,9,20,30,53,29,47,133
Golden State,64,"March 8, 2017",Boston,1,0,86,99,1,48,86,46,23,8,13,17,20,34,12,37,84,6,30,31,54,6,9,109
Chicago,64,"March 8, 2017",Orlando,0,0,91,98,1,48,91,44,24,3,4,16,16,35,9,36,81,12,28,24,53,7,11,101
Denver,64,"March 8, 2017",Washington,1,0,113,123,1,48,113,39,31,6,2,16,16,29,10,46,87,13,28,33,59,8,17,125
Miami,64,"March 6, 2017",Cleveland,0,1,106,98,1,48,106,38,23,7,6,7,19,30,8,39,91,16,35,23,56,12,14,119
Utah,64,"March 6, 2017",New Orleans,1,1,88,83,1,48,88,46,16,10,2,19,17,34,12,33,81,10,27,23,54,12,15,92
Portland,64,"March 11, 2017",Washington,1,0,124,125,1,53,124,43,26,4,5,14,19,36,7,48,94,16,32,32,62,12,16,138
L.A. Clippers,64,"March 8, 2017",Minnesota,0,0,91,107,1,48,91,36,18,9,3,16,18,26,10,35,83,9,24,26,59,12,18,87
Sacramento,64,"March 8, 2017",San Antonio,0,0,104,114,1,48,104,42,20,7,4,13,22,37,5,42,86,7,19,35,67,13,16,117
New Orleans,64,"March 6, 2017",Utah,0,0,83,88,1,48,83,47,16,11,3,20,15,34,13,30,84,10,33,20,51,13,18,81
Detroit,64,"March 8, 2017",Indiana,0,0,98,115,1,48,98,45,20,4,4,10,18,34,11,39,89,7,26,32,63,13,22,102
Houston,64,"March 6, 2017",San Antonio,0,0,110,112,1,48,110,43,19,3,3,11,20,36,7,41,88,14,39,27,49,14,17,117
Toronto,64,"March 8, 2017",New Orleans,0,1,94,87,1,48,94,42,21,6,6,11,18,34,8,36,76,8,21,28,55,14,23,109
Philadelphia,64,"March 9, 2017",Portland,0,0,108,114,1,53,108,44,18,10,3,16,29,32,12,41,94,11,29,30,65,15,20,109
Cleveland,64,"March 11, 2017",Orlando,0,1,116,104,1,48,116,51,30,2,5,9,18,42,9,43,86,15,39,28,47,15,25,142
Indiana,64,"March 8, 2017",Detroit,1,1,115,98,1,48,115,46,27,3,2,5,18,37,9,44,88,11,23,33,65,16,19,141
San Antonio,64,"March 9, 2017",Oklahoma City,0,0,92,102,1,48,92,40,15,8,8,14,16,27,13,35,84,6,19,29,65,16,20,96
L.A. Lakers,64,"March 7, 2017",Dallas,0,0,111,122,1,48,111,44,25,9,3,11,20,33,11,42,90,11,30,31,60,16,22,127
Orlando,64,"March 6, 2017",New York,1,0,105,113,1,48,105,42,23,4,5,13,23,31,11,40,85,9,32,31,53,16,24,113
Washington,64,"March 10, 2017",Sacramento,0,1,130,122,1,53,130,52,29,7,5,9,22,40,12,52,104,9,26,43,78,17,19,160
Brooklyn,64,"March 10, 2017",Dallas,0,0,96,105,1,48,96,35,23,9,2,12,28,31,4,34,78,9,31,25,47,19,23,105
Charlotte,64,"March 8, 2017",Miami,0,0,101,108,1,48,101,39,14,7,8,12,17,33,6,37,80,7,21,30,59,20,21,113
Minnesota,64,"March 10, 2017",Golden State,1,1,103,102,1,48,103,46,21,6,3,11,18,32,14,39,88,4,14,35,74,21,27,113
Oklahoma City,64,"March 7, 2017",Portland,1,0,121,126,1,48,121,39,16,4,1,17,25,27,12,44,85,10,25,34,60,23,30,116
Boston,64,"March 6, 2017",L.A.Clippers,0,0,102,116,1,48,102,37,22,9,2,11,31,30,7,34,83,10,35,24,48,24,29,107
Atlanta,64,"March 8, 2017",Brooklyn,1,1,110,105,1,48,110,47,19,12,7,15,22,36,11,41,95,4,20,37,75,24,32,118
Dallas,64,"March 10, 2017",Brooklyn,1,1,105,96,1,48,105,47,16,5,0,15,18,40,7,33,78,14,33,19,45,25,28,110
Milwaukee,64,"March 10, 2017",Indiana,1,1,99,85,1,48,99,34,17,13,6,20,21,29,5,33,64,7,17,26,47,26,30,114
Phoenix,64,"March 7, 2017",Washington,1,0,127,131,1,48,127,49,23,5,8,19,32,40,9,44,88,13,27,31,61,26,33,142
New York,64,"March 6, 2017",Orlando,0,1,113,105,1,48,113,45,26,6,1,9,23,33,12,40,86,6,14,34,72,27,28,135
Memphis,64,"March 6, 2017",Brooklyn,1,0,109,122,1,48,109,37,23,7,2,15,29,29,8,34,77,10,25,24,52,31,39,112
New York,65,"March 8, 2017",Milwaukee,0,0,93,104,1,48,93,43,22,4,6,15,20,33,10,39,84,7,20,32,64,8,12,104
Chicago,65,"March 10, 2017",Houston,1,0,94,115,1,48,94,49,24,9,6,18,21,38,11,38,98,9,39,29,59,9,12,101
New Orleans,65,"March 8, 2017",Toronto,1,0,87,94,1,48,87,40,22,6,4,14,20,32,8,34,80,9,29,25,51,10,13,96
Philadelphia,65,"March 11, 2017",L.A.Clippers,0,0,100,112,1,48,100,41,28,11,1,16,23,34,7,40,84,10,30,30,54,10,14,117
Cleveland,65,"March 12, 2017",Houston,0,0,112,117,1,48,112,38,24,3,6,15,23,34,4,42,80,17,43,25,37,11,13,128
Golden State,65,"March 10, 2017",Minnesota,0,0,102,103,1,48,102,43,25,9,5,12,21,31,12,41,88,7,24,34,64,13,17,121
Oklahoma City,65,"March 9, 2017",San Antonio,1,1,102,92,1,48,102,48,23,9,3,11,22,33,15,41,88,6,20,35,68,14,21,120
San Antonio,65,"March 11, 2017",Golden State,1,1,107,85,1,48,107,46,27,6,7,18,18,39,7,40,77,12,27,28,50,15,18,135
Detroit,65,"March 9, 2017",Cleveland,1,1,106,101,1,48,106,45,22,6,2,8,15,34,11,41,87,9,26,32,61,15,19,123
Boston,65,"March 8, 2017",Golden State,0,1,99,86,1,48,99,45,28,12,1,12,10,36,9,37,84,10,29,27,55,15,19,122
Minnesota,65,"March 11, 2017",Milwaukee,0,0,95,102,1,48,95,38,21,4,4,12,22,27,11,37,81,5,13,32,68,16,21,101
L.A. Lakers,65,"March 9, 2017",Phoenix,0,1,122,110,1,48,122,42,21,11,7,9,20,28,14,47,98,12,27,35,71,16,24,135
Charlotte,65,"March 10, 2017",Orlando,1,1,121,81,1,48,121,43,34,6,6,7,17,37,6,47,79,10,21,37,58,17,20,168
Orlando,65,"March 8, 2017",Chicago,1,1,98,91,1,48,98,48,21,10,4,9,17,33,15,37,89,7,25,30,64,17,21,116
Indiana,65,"March 10, 2017",Milwaukee,0,0,85,99,1,48,85,36,15,14,3,18,24,28,8,33,74,2,18,31,56,17,22,89
Memphis,65,"March 9, 2017",L.A.Clippers,1,0,98,114,1,48,98,34,26,6,2,9,22,28,6,37,83,7,20,30,63,17,22,106
Denver,65,"March 10, 2017",Boston,1,1,119,99,1,48,119,49,24,11,4,18,18,38,11,45,85,12,31,33,54,17,22,144
Miami,65,"March 8, 2017",Charlotte,1,1,108,101,1,48,108,46,22,8,7,12,18,33,13,37,85,17,41,20,44,17,24,124
Portland,65,"March 12, 2017",Phoenix,0,1,110,101,1,48,110,49,14,7,6,14,24,40,9,43,86,7,22,36,64,17,25,121
Washington,65,"March 11, 2017",Portland,0,1,125,124,1,53,125,46,27,5,4,11,20,37,9,47,90,12,25,35,65,19,28,144
Atlanta,65,"March 10, 2017",Toronto,1,1,105,99,1,48,105,45,24,8,7,21,20,37,8,39,75,8,22,31,53,19,29,122
Milwaukee,65,"March 11, 2017",Minnesota,1,1,102,95,1,48,102,40,19,5,6,9,23,29,11,37,80,8,20,29,60,20,23,117
Phoenix,65,"March 9, 2017",L.A.Lakers,1,0,110,122,1,48,110,54,20,7,10,19,24,36,18,42,91,6,19,36,72,20,25,128
Utah,65,"March 8, 2017",Houston,0,1,115,108,1,48,115,45,21,2,4,16,23,35,10,41,76,12,31,29,45,21,24,133
Toronto,65,"March 10, 2017",Atlanta,0,0,99,105,1,48,99,46,19,17,5,11,28,30,16,37,92,4,25,33,67,21,27,114
Brooklyn,65,"March 12, 2017",New York,1,1,120,112,1,48,120,55,23,7,3,12,23,42,13,40,87,19,38,21,49,21,29,141
Sacramento,65,"March 10, 2017",Washington,1,0,122,130,1,53,122,40,27,5,1,10,21,32,8,44,92,12,22,32,70,22,28,131
L.A. Clippers,65,"March 9, 2017",Memphis,0,1,114,98,1,48,114,47,24,2,4,14,18,40,7,40,78,11,30,29,48,23,28,134
Houston,65,"March 8, 2017",Utah,1,0,108,115,1,48,108,31,22,9,4,8,20,21,10,35,79,8,32,27,47,30,40,112
Dallas,65,"March 11, 2017",Phoenix,1,0,98,100,1,48,98,48,17,2,2,13,17,38,10,28,74,9,26,19,48,33,36,105
Chicago,66,"March 12, 2017",Boston,0,0,80,100,1,48,80,40,18,13,3,17,10,28,12,33,87,7,25,26,62,7,9,81
New York,66,"March 11, 2017",Detroit,0,0,92,112,1,48,92,44,26,4,7,18,18,36,8,36,82,13,30,23,52,7,11,105
Dallas,66,"March 13, 2017",Toronto,0,0,78,100,1,48,78,34,21,4,6,7,19,27,7,31,85,7,25,24,60,9,13,78
New Orleans,66,"March 11, 2017",Charlotte,0,1,125,122,1,53,125,47,33,4,4,10,16,38,9,50,99,14,34,36,65,11,16,149
Detroit,66,"March 11, 2017",New York,1,1,112,92,1,48,112,51,27,14,6,7,15,37,14,46,96,9,27,37,69,11,19,145
Sacramento,66,"March 11, 2017",Denver,1,0,92,105,1,48,92,41,24,4,2,12,15,31,10,36,82,8,23,28,59,12,20,97
San Antonio,66,"March 13, 2017",Atlanta,1,1,107,99,1,48,107,44,31,6,9,21,22,37,7,39,81,16,34,23,47,13,17,130
Orlando,66,"March 10, 2017",Charlotte,0,0,81,121,1,48,81,31,19,4,2,10,24,23,8,31,76,5,27,26,49,14,22,74
Golden State,66,"March 11, 2017",San Antonio,0,0,85,107,1,48,85,49,19,10,4,15,16,29,20,33,92,5,17,28,75,14,23,84
Denver,66,"March 11, 2017",Sacramento,0,1,105,92,1,48,105,44,21,8,8,9,16,35,9,40,85,9,34,31,51,16,18,130
Charlotte,66,"March 11, 2017",New Orleans,1,0,122,125,1,53,122,50,32,5,3,9,14,39,11,46,102,13,46,33,56,17,20,144
Milwaukee,66,"March 13, 2017",Memphis,0,0,93,113,1,48,93,32,21,6,5,16,21,24,8,31,67,14,26,17,41,17,20,102
Memphis,66,"March 11, 2017",Atlanta,1,0,90,107,1,48,90,41,22,11,3,13,21,28,13,34,90,5,29,29,61,17,23,92
Cleveland,66,"March 14, 2017",Detroit,1,1,128,96,1,48,128,41,29,4,3,9,18,38,3,46,77,19,30,27,47,17,23,159
Phoenix,66,"March 11, 2017",Dallas,0,1,100,98,1,48,100,39,18,5,8,12,24,35,4,38,81,6,20,32,61,18,20,113
Oklahoma City,66,"March 11, 2017",Utah,1,1,112,104,1,48,112,43,23,7,7,12,20,31,12,43,86,8,23,35,63,18,24,131
Minnesota,66,"March 13, 2017",Washington,1,1,119,104,1,48,119,46,27,8,7,15,24,38,8,45,86,10,21,35,65,19,22,148
Boston,66,"March 10, 2017",Denver,0,0,99,119,1,48,99,33,19,11,2,18,23,25,8,34,80,12,33,22,47,19,23,96
Portland,66,"March 14, 2017",New Orleans,0,0,77,100,1,48,77,48,13,3,1,16,20,40,8,23,76,11,32,12,44,20,26,67
Atlanta,66,"March 11, 2017",Memphis,0,1,107,90,1,48,107,46,22,9,6,18,23,40,6,36,72,15,30,21,42,20,26,130
Toronto,66,"March 11, 2017",Miami,0,0,89,104,1,48,89,48,7,6,5,12,20,32,16,33,88,2,15,31,73,21,25,84
Utah,66,"March 11, 2017",Oklahoma City,0,0,104,112,1,48,104,36,15,9,2,12,17,29,7,36,75,9,20,27,55,23,28,110
Miami,66,"March 11, 2017",Toronto,1,1,104,89,1,48,104,35,21,8,10,12,19,32,3,35,72,11,28,24,44,23,33,119
L.A. Lakers,66,"March 12, 2017",Philadelphia,1,0,116,118,1,48,116,40,24,10,10,15,21,33,7,44,88,4,20,40,68,24,28,137
L.A. Clippers,66,"March 11, 2017",Philadelphia,1,1,112,100,1,48,112,41,25,13,3,13,13,33,8,40,81,8,25,32,56,24,29,135
Washington,66,"March 13, 2017",Minnesota,0,0,104,119,1,48,104,39,15,10,2,15,25,31,8,36,84,7,26,29,58,25,31,101
Brooklyn,66,"March 14, 2017",Oklahoma City,1,0,104,122,1,48,104,30,20,8,4,18,23,26,4,33,71,12,24,21,47,26,30,106
Philadelphia,66,"March 12, 2017",L.A.Lakers,0,1,118,116,1,48,118,34,28,8,4,16,24,30,4,41,79,10,24,31,55,26,32,132
Houston,66,"March 10, 2017",Chicago,0,1,115,94,1,48,115,54,26,11,4,17,15,43,11,37,89,15,47,22,42,26,32,135
Indiana,66,"March 12, 2017",Miami,1,1,102,98,1,48,102,46,12,2,4,9,15,35,11,35,82,5,15,30,67,27,32,105
Boston,67,"March 12, 2017",Chicago,1,1,100,80,1,48,100,51,22,14,5,21,14,39,12,40,86,16,37,24,49,4,4,125
Indiana,67,"March 14, 2017",New York,0,0,81,87,1,48,81,53,16,6,3,16,14,39,14,32,87,8,29,24,58,9,15,82
Cleveland,67,"March 16, 2017",Utah,1,1,91,83,1,48,91,52,14,6,2,10,12,41,11,36,86,9,33,27,53,10,19,96
San Antonio,67,"March 15, 2017",Portland,1,0,106,110,1,48,106,41,28,7,5,14,20,31,10,42,88,11,26,31,62,11,15,123
Miami,67,"March 12, 2017",Indiana,0,0,98,102,1,48,98,54,18,4,4,8,22,35,19,39,94,9,32,30,62,11,16,110
L.A. Lakers,67,"March 13, 2017",Denver,0,0,101,129,1,48,101,46,17,10,3,16,21,30,16,42,97,6,20,36,77,11,19,98
Phoenix,67,"March 12, 2017",Portland,1,0,101,110,1,48,101,42,20,5,3,9,21,35,7,41,94,5,14,36,80,14,20,103
Washington,67,"March 15, 2017",Dallas,1,0,107,112,1,48,107,42,30,4,1,12,23,37,5,40,82,12,30,28,52,15,21,124
Charlotte,67,"March 13, 2017",Chicago,1,0,109,115,1,48,109,44,25,4,4,6,18,33,11,43,93,7,29,36,64,16,19,127
Minnesota,67,"March 15, 2017",Boston,0,0,104,117,1,48,104,42,26,4,1,8,21,27,15,40,91,8,27,32,64,16,20,114
Sacramento,67,"March 13, 2017",Orlando,1,1,120,115,1,48,120,40,24,9,5,15,14,38,2,44,82,16,30,28,52,16,21,140
Toronto,67,"March 13, 2017",Dallas,1,1,100,78,1,48,100,55,19,7,6,12,16,46,9,37,78,9,25,28,53,17,18,133
Memphis,67,"March 13, 2017",Milwaukee,1,1,113,93,1,48,113,37,30,11,0,12,20,26,11,41,79,14,27,27,52,17,23,135
Detroit,67,"March 14, 2017",Cleveland,0,0,96,128,1,48,96,45,20,6,1,8,19,29,16,37,99,4,19,33,80,18,19,97
Utah,67,"March 13, 2017",L.A.Clippers,1,1,114,108,1,48,114,42,22,1,3,7,22,34,8,41,78,14,21,27,57,18,22,134
L.A. Clippers,67,"March 13, 2017",Utah,0,0,108,114,1,48,108,28,16,4,2,6,22,25,3,39,78,12,30,27,48,18,23,108
Dallas,67,"March 15, 2017",Washington,0,1,112,107,1,48,112,40,24,5,2,10,22,35,5,40,79,14,32,26,47,18,25,127
Philadelphia,67,"March 14, 2017",Golden State,0,0,104,106,1,48,104,50,28,11,9,21,26,38,12,39,88,8,27,31,61,18,27,123
New Orleans,67,"March 14, 2017",Portland,1,1,100,77,1,48,100,49,19,10,8,5,18,45,4,38,80,6,21,32,59,18,30,127
Chicago,67,"March 13, 2017",Charlotte,0,1,115,109,1,48,115,49,29,6,5,10,20,38,11,41,91,14,40,27,51,19,22,141
Milwaukee,67,"March 15, 2017",L.A.Clippers,0,1,97,96,1,48,97,36,22,8,2,11,25,32,4,34,76,10,29,24,47,19,25,106
Houston,67,"March 12, 2017",Cleveland,1,1,117,112,1,48,117,52,25,10,4,6,17,32,20,41,96,16,45,25,51,19,28,138
Atlanta,67,"March 13, 2017",San Antonio,0,0,99,107,1,48,99,36,27,13,3,16,20,30,6,37,81,6,22,31,59,19,30,107
Denver,67,"March 13, 2017",L.A.Lakers,1,1,129,101,1,48,129,42,36,9,7,15,18,36,6,45,84,17,38,28,46,22,25,166
Orlando,67,"March 11, 2017",Cleveland,1,0,104,116,1,48,104,53,17,6,1,6,21,38,15,38,96,4,21,34,75,24,28,113
Oklahoma City,67,"March 14, 2017",Brooklyn,0,1,122,104,1,48,122,44,30,13,6,15,27,31,13,44,87,10,22,34,65,24,34,147
Portland,67,"March 15, 2017",San Antonio,0,1,110,106,1,48,110,39,21,10,1,11,16,31,8,38,80,9,22,29,58,25,28,125
New York,67,"March 12, 2017",Brooklyn,0,0,112,120,1,48,112,43,22,5,8,9,20,32,11,39,94,8,23,31,71,26,32,120
Golden State,67,"March 14, 2017",Philadelphia,1,1,106,104,1,48,106,42,24,12,10,18,24,29,13,32,87,14,32,18,55,28,35,114
Brooklyn,67,"March 16, 2017",New York,0,1,121,110,1,48,121,50,19,5,2,13,23,38,12,41,85,10,31,31,54,29,35,134
Indiana,68,"March 15, 2017",Charlotte,1,1,98,77,1,48,98,42,26,8,6,14,15,39,3,39,73,12,28,27,45,8,9,131
Detroit,68,"March 15, 2017",Utah,1,0,83,97,1,48,83,39,14,6,4,7,18,31,8,36,86,3,13,33,73,8,12,85
New York,68,"March 14, 2017",Indiana,1,1,87,81,1,48,87,52,21,8,4,14,15,41,11,35,83,9,28,26,55,8,13,105
Cleveland,68,"March 18, 2017",L.A.Clippers,0,0,78,108,1,48,78,40,15,5,0,12,24,36,4,32,83,5,27,27,56,9,13,71
Phoenix,68,"March 15, 2017",Sacramento,1,0,101,107,1,48,101,47,24,9,11,13,25,31,16,43,107,6,25,37,82,9,14,110
Dallas,68,"March 17, 2017",Philadelphia,0,0,74,116,1,48,74,34,21,6,4,12,20,29,5,30,87,5,23,25,64,9,17,62
Washington,68,"March 17, 2017",Chicago,1,1,112,107,1,48,112,41,34,5,6,10,17,27,14,46,101,10,26,36,75,10,12,131
Charlotte,68,"March 15, 2017",Indiana,0,0,77,98,1,48,77,30,15,9,4,10,13,27,3,32,80,3,23,29,57,10,13,74
Orlando,68,"March 13, 2017",Sacramento,0,0,115,120,1,48,115,44,32,10,4,13,18,35,9,45,97,13,34,32,63,12,12,140
Chicago,68,"March 15, 2017",Memphis,1,0,91,98,1,48,91,45,22,6,6,5,19,31,14,34,91,11,28,23,63,12,15,105
Utah,68,"March 15, 2017",Detroit,0,1,97,83,1,48,97,43,28,6,5,15,15,37,6,36,77,13,28,23,49,12,16,119
Golden State,68,"March 16, 2017",Orlando,1,1,122,92,1,48,122,47,36,14,9,12,18,40,7,50,87,10,26,40,61,12,23,168
L.A. Lakers,68,"March 15, 2017",Houston,0,0,100,139,1,48,100,38,16,10,0,22,25,29,9,42,91,3,25,39,66,13,18,88
Memphis,68,"March 15, 2017",Chicago,0,1,98,91,1,48,98,52,26,2,3,11,19,38,14,36,85,11,31,25,54,15,18,118
Oklahoma City,68,"March 16, 2017",Toronto,0,1,123,102,1,48,123,47,33,10,1,18,22,37,10,47,88,14,25,33,63,15,19,151
Miami,68,"March 15, 2017",New Orleans,1,1,120,112,1,48,120,45,23,9,3,15,22,33,12,44,87,16,35,28,52,16,19,139
Portland,68,"March 18, 2017",Atlanta,0,1,113,97,1,48,113,54,23,9,9,20,22,41,13,44,87,8,18,36,69,17,19,143
Boston,68,"March 15, 2017",Minnesota,1,1,117,104,1,48,117,37,34,2,6,10,16,32,5,43,79,13,33,30,46,18,21,147
New Orleans,68,"March 15, 2017",Miami,0,0,112,120,1,48,112,38,21,9,5,13,13,30,8,42,88,9,22,33,66,19,28,117
Philadelphia,68,"March 17, 2017",Dallas,1,1,116,74,1,48,116,55,32,8,6,16,21,46,9,42,80,12,29,30,51,20,23,160
Minnesota,68,"March 17, 2017",Miami,0,0,105,123,1,48,105,28,14,6,6,11,21,19,9,41,82,2,12,39,70,21,22,106
San Antonio,68,"March 18, 2017",Memphis,0,0,96,104,1,48,96,42,18,2,5,15,25,33,9,33,75,9,28,24,47,21,22,105
L.A. Clippers,68,"March 15, 2017",Milwaukee,1,0,96,97,1,48,96,42,23,3,4,15,20,36,6,35,75,5,24,30,51,21,29,105
Houston,68,"March 15, 2017",L.A.Lakers,1,1,139,100,1,48,139,50,37,13,4,19,21,37,13,50,91,18,43,32,48,21,32,172
Denver,68,"March 16, 2017",L.A.Clippers,1,1,129,114,1,48,129,48,31,7,3,10,14,37,11,46,86,15,28,31,58,22,26,164
Milwaukee,68,"March 17, 2017",L.A.Lakers,0,1,107,103,1,48,107,43,22,7,9,14,25,33,10,40,82,4,24,36,58,23,30,125
Toronto,68,"March 16, 2017",Oklahoma City,1,0,102,123,1,48,102,32,15,10,10,14,20,26,6,37,81,5,20,32,61,23,30,104
Brooklyn,68,"March 17, 2017",Boston,1,0,95,98,1,48,95,41,23,7,7,10,25,35,6,30,83,11,35,19,48,24,30,104
Sacramento,68,"March 15, 2017",Phoenix,0,1,107,101,1,48,107,48,22,8,11,18,18,40,8,38,79,6,14,32,65,25,34,128
Atlanta,68,"March 16, 2017",Memphis,1,0,91,103,1,48,91,38,19,6,9,17,17,30,8,29,71,8,27,21,44,25,34,95
Utah,69,"March 16, 2017",Cleveland,0,0,83,91,1,48,83,48,18,6,3,16,16,37,11,34,82,5,21,29,61,10,14,90
L.A. Clippers,69,"March 16, 2017",Denver,0,0,114,129,1,48,114,34,26,5,4,9,19,30,4,44,84,16,32,28,52,10,15,129
Milwaukee,69,"March 18, 2017",Golden State,0,0,92,117,1,48,92,35,19,8,7,11,17,23,12,36,89,9,27,27,62,11,14,94
Philadelphia,69,"March 19, 2017",Boston,1,1,105,99,1,48,105,42,29,9,7,15,23,35,7,41,87,12,33,29,54,11,15,127
Minnesota,69,"March 19, 2017",New Orleans,0,0,109,123,1,48,109,36,30,11,5,16,14,27,9,44,85,9,25,35,60,12,17,129
Chicago,69,"March 17, 2017",Washington,0,0,107,112,1,48,107,52,28,5,6,18,19,37,15,44,88,7,27,37,61,12,18,130
Detroit,69,"March 17, 2017",Toronto,1,0,75,87,1,48,75,49,14,5,5,12,17,37,12,29,83,3,20,26,63,14,21,75
Memphis,69,"March 16, 2017",Atlanta,0,1,103,91,1,48,103,48,29,7,5,11,25,32,16,39,92,10,28,29,64,15,18,125
Miami,69,"March 17, 2017",Minnesota,1,1,123,105,1,48,123,40,29,6,9,15,16,30,10,50,85,8,26,42,59,15,19,153
Golden State,69,"March 18, 2017",Milwaukee,1,1,117,92,1,48,117,44,30,5,6,12,16,38,6,45,75,12,23,33,52,15,19,156
Orlando,69,"March 16, 2017",Golden State,0,0,92,122,1,48,92,49,15,7,4,19,21,33,16,35,94,7,27,28,67,15,21,83
L.A. Lakers,69,"March 17, 2017",Milwaukee,1,0,103,107,1,48,103,40,24,7,4,14,20,29,11,38,84,11,29,27,55,16,26,108
Toronto,69,"March 17, 2017",Detroit,0,1,87,75,1,48,87,53,19,5,2,12,21,45,8,30,78,9,27,21,51,18,20,104
New Orleans,69,"March 17, 2017",Houston,1,1,128,112,1,48,128,53,29,9,5,13,20,44,9,49,92,12,34,37,58,18,24,162
Portland,69,"March 19, 2017",Miami,0,1,115,104,1,48,115,43,13,4,6,11,20,30,13,42,83,13,26,29,57,18,24,123
Oklahoma City,69,"March 18, 2017",Sacramento,1,1,110,94,1,48,110,49,23,7,4,14,21,36,13,41,82,10,26,31,56,18,25,131
Sacramento,69,"March 18, 2017",Oklahoma City,0,0,94,110,1,48,94,35,16,9,2,12,22,26,9,35,85,5,21,30,64,19,23,90
Dallas,69,"March 19, 2017",Brooklyn,0,1,111,104,1,48,111,33,20,8,3,10,24,31,2,41,76,10,25,31,51,19,25,124
Indiana,69,"March 19, 2017",Toronto,0,0,91,116,1,48,91,33,22,7,3,13,23,24,9,33,80,6,23,27,57,19,26,89
Charlotte,69,"March 18, 2017",Washington,1,1,98,93,1,48,98,41,23,8,8,7,20,35,6,35,82,9,24,26,58,19,27,116
Denver,69,"March 18, 2017",Houston,1,0,105,109,1,48,105,45,28,9,6,13,24,32,13,38,89,10,31,28,58,19,30,118
San Antonio,69,"March 19, 2017",Sacramento,1,1,118,102,1,48,118,45,31,9,3,6,20,30,15,43,87,11,28,32,59,21,27,150
Cleveland,69,"March 19, 2017",L.A.Lakers,0,1,125,120,1,48,125,44,19,4,2,10,16,34,10,45,85,13,36,32,49,22,27,139
Boston,69,"March 17, 2017",Brooklyn,0,1,98,95,1,48,98,51,20,7,6,12,23,43,8,34,85,7,29,27,56,23,29,113
Washington,69,"March 18, 2017",Charlotte,0,0,93,98,1,48,93,44,21,6,7,12,21,36,8,29,79,11,33,18,46,24,31,102
New York,69,"March 16, 2017",Brooklyn,1,0,110,121,1,48,110,34,20,6,4,7,26,29,5,41,88,3,16,38,72,25,26,119
Phoenix,69,"March 17, 2017",Orlando,1,0,103,109,1,48,103,49,18,9,8,16,22,37,12,38,87,2,14,36,73,25,30,117
Houston,69,"March 17, 2017",New Orleans,0,0,112,128,1,48,112,46,18,6,3,13,19,36,10,37,89,13,40,24,49,25,32,113
Atlanta,69,"March 18, 2017",Portland,1,0,97,113,1,48,97,35,22,13,7,13,12,23,12,32,88,7,26,25,62,26,32,99
Brooklyn,69,"March 19, 2017",Dallas,1,0,104,111,1,48,104,41,16,2,1,15,22,32,9,31,72,13,31,18,41,29,38,99
Atlanta,70,"March 20, 2017",Charlotte,0,0,90,105,1,48,90,45,26,3,6,15,17,33,12,37,84,12,37,25,47,4,10,102
Dallas,70,"March 21, 2017",Golden State,1,0,87,112,1,48,87,39,24,8,2,11,14,26,13,33,92,11,34,22,58,10,12,88
Milwaukee,70,"March 21, 2017",Portland,0,1,93,90,1,48,93,49,16,8,8,13,22,36,13,38,90,7,16,31,74,10,12,107
New Orleans,70,"March 19, 2017",Minnesota,1,1,123,109,1,48,123,42,31,8,1,16,15,33,9,49,89,14,30,35,59,11,15,145
Chicago,70,"March 18, 2017",Utah,1,1,95,86,1,48,95,39,24,7,9,10,18,32,7,38,80,7,19,31,61,12,14,120
Cleveland,70,"March 22, 2017",Denver,0,0,113,126,1,48,113,38,22,4,4,10,12,31,7,43,85,15,37,28,48,12,14,127
Brooklyn,70,"March 21, 2017",Detroit,1,1,98,96,1,48,98,46,22,1,6,10,13,35,11,38,88,10,29,28,59,12,19,106
Sacramento,70,"March 19, 2017",San Antonio,0,0,102,118,1,48,102,40,29,4,4,11,20,31,9,41,83,7,10,34,73,13,17,122
Miami,70,"March 19, 2017",Portland,1,0,104,115,1,48,104,39,18,8,8,9,22,26,13,41,89,9,31,32,58,13,20,113
Charlotte,70,"March 20, 2017",Atlanta,1,1,105,90,1,48,105,33,28,12,5,7,13,28,5,40,80,12,30,28,50,13,20,129
Toronto,70,"March 19, 2017",Indiana,1,1,116,91,1,48,116,51,25,7,7,16,20,37,14,45,91,12,27,33,64,14,16,142
L.A. Lakers,70,"March 19, 2017",Cleveland,1,0,120,125,1,48,120,40,23,5,2,5,25,30,10,47,91,11,27,36,64,15,19,137
Golden State,70,"March 20, 2017",Oklahoma City,0,1,111,95,1,48,111,46,28,8,8,16,22,37,9,40,83,15,33,25,50,16,21,137
Portland,70,"March 21, 2017",Milwaukee,1,0,90,93,1,48,90,49,15,8,6,14,14,36,13,35,83,4,21,31,62,16,26,96
Utah,70,"March 18, 2017",Chicago,0,0,86,95,1,48,86,49,15,6,8,14,12,32,17,31,81,7,25,24,56,17,25,92
Oklahoma City,70,"March 20, 2017",Golden State,1,0,95,111,1,48,95,40,18,10,2,11,19,28,12,37,87,4,21,33,66,17,31,90
Orlando,70,"March 17, 2017",Phoenix,0,1,109,103,1,48,109,43,21,10,4,12,27,35,8,42,96,7,23,35,73,18,21,118
San Antonio,70,"March 21, 2017",Minnesota,0,1,100,93,1,48,100,33,22,12,5,15,19,24,9,37,77,8,24,29,53,18,22,113
New York,70,"March 20, 2017",L.A.Clippers,0,0,105,114,1,48,105,48,24,6,1,12,19,34,14,40,89,6,24,34,65,19,24,118
Phoenix,70,"March 19, 2017",Detroit,0,0,95,112,1,48,95,47,16,10,4,4,21,36,11,35,99,6,22,29,77,19,30,93
Washington,70,"March 20, 2017",Boston,0,0,102,110,1,48,102,39,24,6,5,18,28,31,8,37,86,8,35,29,51,20,26,103
L.A. Clippers,70,"March 18, 2017",Cleveland,1,1,108,78,1,48,108,54,27,4,3,14,15,47,7,40,78,8,26,32,52,20,29,135
Detroit,70,"March 19, 2017",Phoenix,1,1,112,95,1,48,112,63,26,2,4,12,21,51,12,40,92,12,25,28,67,20,30,133
Indiana,70,"March 20, 2017",Utah,1,1,107,100,1,48,107,43,21,9,9,7,19,33,10,38,87,10,20,28,67,21,23,131
Philadelphia,70,"March 20, 2017",Orlando,0,0,109,112,1,53,109,53,26,15,6,16,34,40,13,39,102,9,34,30,68,22,24,128
Minnesota,70,"March 21, 2017",San Antonio,1,0,93,100,1,48,93,39,20,10,2,23,24,27,12,32,72,7,15,25,57,22,25,98
Denver,70,"March 20, 2017",Houston,0,0,124,125,1,48,124,48,26,7,3,19,18,40,8,44,86,12,29,32,57,24,26,145
Boston,70,"March 19, 2017",Philadelphia,0,0,99,105,1,48,99,41,27,8,4,17,15,33,8,34,85,6,29,28,56,25,29,107
Memphis,70,"March 18, 2017",San Antonio,1,1,104,96,1,48,104,35,20,7,3,10,18,28,7,32,76,13,30,19,46,27,31,111
Houston,70,"March 18, 2017",Denver,0,1,109,105,1,48,109,48,20,5,5,14,24,38,10,38,83,5,24,33,59,28,35,121
Sacramento,71,"March 22, 2017",Milwaukee,1,0,98,116,1,48,98,37,19,6,6,12,15,29,8,41,84,10,26,31,58,6,10,107
Memphis,71,"March 21, 2017",New Orleans,0,0,82,95,1,48,82,42,17,7,3,15,20,37,5,32,79,9,35,23,44,9,13,85
Detroit,71,"March 21, 2017",Brooklyn,0,0,96,98,1,48,96,51,17,8,8,6,17,41,10,40,92,5,23,35,69,11,16,117
Dallas,71,"March 23, 2017",L.A.Clippers,1,1,97,95,1,48,97,34,26,11,4,9,18,30,4,38,82,9,26,29,56,12,18,113
Denver,71,"March 22, 2017",Cleveland,1,1,126,113,1,48,126,44,35,7,1,6,16,34,10,51,96,11,26,40,70,13,13,162
Golden State,71,"March 21, 2017",Dallas,0,1,112,87,1,48,112,46,34,10,2,16,20,42,4,43,78,13,30,30,48,13,16,150
Indiana,71,"March 22, 2017",Boston,0,0,100,109,1,48,100,45,20,13,6,13,19,27,18,38,87,11,28,27,59,13,19,116
Milwaukee,71,"March 22, 2017",Sacramento,0,1,116,98,1,48,116,38,28,9,4,10,11,31,7,43,81,16,35,27,46,14,19,142
Utah,71,"March 20, 2017",Indiana,0,0,100,107,1,48,100,49,20,5,11,10,17,36,13,40,88,6,26,34,62,14,20,121
Philadelphia,71,"March 22, 2017",Oklahoma City,0,0,97,122,1,48,97,25,19,8,4,9,23,19,6,37,87,8,25,29,62,15,17,92
San Antonio,71,"March 23, 2017",Memphis,1,1,97,90,1,48,97,35,26,6,5,6,19,29,6,37,77,8,26,29,51,15,23,115
New York,71,"March 22, 2017",Utah,0,0,101,108,1,48,101,36,19,4,1,11,26,28,8,38,79,9,21,29,58,16,18,107
Charlotte,71,"March 22, 2017",Orlando,0,1,109,102,1,48,109,43,24,9,3,10,12,31,12,42,90,9,27,33,63,16,18,128
New Orleans,71,"March 21, 2017",Memphis,1,1,95,82,1,48,95,51,16,8,3,12,17,39,12,35,88,9,29,26,59,16,19,105
Washington,71,"March 22, 2017",Atlanta,1,1,104,100,1,48,104,55,23,9,6,19,26,37,18,38,95,11,34,27,61,17,23,115
Miami,71,"March 21, 2017",Phoenix,1,1,112,97,1,48,112,50,17,13,5,14,25,32,18,42,96,11,27,31,69,17,23,123
L.A. Lakers,71,"March 21, 2017",L.A.Clippers,1,0,109,133,1,48,109,41,23,8,3,8,22,27,14,43,92,6,20,37,72,17,27,117
Houston,71,"March 20, 2017",Denver,1,1,125,124,1,48,125,35,27,12,2,12,22,29,6,45,89,17,38,28,51,18,23,140
L.A. Clippers,71,"March 20, 2017",New York,1,1,114,105,1,48,114,43,25,8,4,9,19,34,9,43,87,10,31,33,56,18,24,135
Minnesota,71,"March 24, 2017",L.A.Lakers,0,0,119,130,1,53,119,37,32,13,10,13,20,25,12,46,95,7,21,39,74,20,22,147
Toronto,71,"March 21, 2017",Chicago,1,1,122,120,1,53,122,50,18,6,4,16,23,34,16,47,95,8,23,39,72,20,27,129
Boston,71,"March 20, 2017",Washington,1,1,110,102,1,48,110,54,19,10,6,13,24,34,20,40,94,10,33,30,61,20,28,124
Cleveland,71,"March 24, 2017",Charlotte,0,1,112,105,1,48,112,38,26,6,5,12,22,35,3,41,74,9,25,32,49,21,24,139
Phoenix,71,"March 21, 2017",Miami,0,0,97,112,1,48,97,41,14,5,5,24,23,31,10,36,82,4,16,32,66,21,29,84
Portland,71,"March 23, 2017",New York,1,1,110,95,1,48,110,50,15,8,2,13,20,40,10,39,80,11,21,28,59,21,29,123
Chicago,71,"March 21, 2017",Toronto,0,0,120,122,1,53,120,39,25,9,10,14,24,30,9,42,90,14,37,28,53,22,27,136
Oklahoma City,71,"March 22, 2017",Philadelphia,1,1,122,97,1,48,122,54,26,7,8,16,17,36,18,48,88,4,16,44,72,22,30,153
Atlanta,71,"March 22, 2017",Washington,0,0,100,104,1,48,100,44,20,11,5,16,19,33,11,34,86,8,25,26,61,24,29,107
Brooklyn,71,"March 23, 2017",Phoenix,1,1,126,98,1,48,126,61,25,11,5,17,26,44,17,43,95,8,29,35,66,32,42,149
Orlando,71,"March 20, 2017",Philadelphia,1,1,112,109,1,53,112,55,19,10,4,18,22,41,14,35,93,4,23,31,70,38,46,116
San Antonio,72,"March 25, 2017",New York,1,1,106,98,1,48,106,50,28,11,6,14,18,34,16,45,99,10,25,35,74,6,8,131
Orlando,72,"March 22, 2017",Charlotte,1,0,102,109,1,48,102,43,26,5,3,14,19,30,13,40,88,14,40,26,48,8,10,115
Indiana,72,"March 24, 2017",Denver,1,0,117,125,1,48,117,39,19,9,8,12,29,28,11,48,95,13,24,35,71,8,11,130
Sacramento,72,"March 24, 2017",Golden State,0,0,100,114,1,48,100,37,27,7,4,19,16,31,6,40,83,10,21,30,62,10,13,110
Detroit,72,"March 22, 2017",Chicago,0,0,95,117,1,48,95,44,18,6,1,15,17,28,16,39,88,7,20,32,68,10,17,93
New Orleans,72,"March 24, 2017",Houston,0,0,107,117,1,48,107,36,28,9,7,10,15,30,6,41,91,14,38,27,53,11,14,124
Portland,72,"March 25, 2017",Minnesota,1,1,112,100,1,48,112,35,24,6,3,14,20,30,5,45,72,11,22,34,50,11,17,133
Boston,72,"March 22, 2017",Indiana,1,1,109,100,1,48,109,43,27,5,2,16,17,33,10,43,84,11,27,32,57,12,14,127
Memphis,72,"March 23, 2017",San Antonio,0,0,90,97,1,48,90,42,18,4,4,13,18,32,10,34,78,10,29,24,49,12,15,98
Chicago,72,"March 22, 2017",Detroit,1,1,117,95,1,48,117,36,36,12,3,11,20,29,7,47,80,11,23,36,57,12,19,153
Milwaukee,72,"March 24, 2017",Atlanta,1,1,100,97,1,48,100,35,27,10,6,8,23,26,9,39,88,8,27,31,61,14,16,119
Miami,72,"March 23, 2017",Toronto,1,0,84,101,1,48,84,36,20,8,11,16,23,26,10,32,82,6,23,26,59,14,23,84
Houston,72,"March 24, 2017",New Orleans,1,1,117,107,1,48,117,59,29,5,3,18,19,44,15,44,93,14,39,30,54,15,20,141
Golden State,72,"March 24, 2017",Sacramento,1,1,114,100,1,48,114,44,37,14,8,12,15,31,13,44,89,10,31,34,58,16,18,158
Dallas,72,"March 25, 2017",Toronto,1,0,86,94,1,48,86,40,20,10,4,12,16,28,12,31,82,7,28,24,54,17,20,94
Philadelphia,72,"March 24, 2017",Chicago,0,1,117,107,1,48,117,46,23,10,4,18,22,35,11,46,83,8,25,38,58,17,23,139
New York,72,"March 23, 2017",Portland,0,0,95,110,1,48,95,40,23,5,9,11,20,31,9,36,88,5,22,31,66,18,20,107
Charlotte,72,"March 24, 2017",Cleveland,1,0,105,112,1,48,105,42,18,6,4,9,17,28,14,38,90,10,38,28,52,19,24,109
Brooklyn,72,"March 24, 2017",Washington,0,0,108,129,1,48,108,38,24,5,4,14,22,32,6,43,82,3,15,40,67,19,26,119
Utah,72,"March 22, 2017",New York,1,1,108,101,1,48,108,46,18,5,7,7,11,28,18,41,89,7,28,34,61,19,29,119
Oklahoma City,72,"March 26, 2017",Houston,0,0,125,137,1,48,125,42,27,15,3,16,21,26,16,47,94,11,30,36,64,20,28,141
Washington,72,"March 24, 2017",Brooklyn,1,1,129,108,1,48,129,46,29,9,5,10,19,35,11,49,97,10,26,39,71,21,22,159
Atlanta,72,"March 24, 2017",Milwaukee,0,0,97,100,1,48,97,49,20,5,3,17,19,36,13,34,83,8,22,26,61,21,24,105
Cleveland,72,"March 25, 2017",Washington,1,0,115,127,1,48,115,32,24,6,6,13,18,21,11,41,83,12,33,29,50,21,27,122
Phoenix,72,"March 23, 2017",Brooklyn,0,0,98,126,1,48,98,50,16,14,3,19,30,35,15,34,93,7,25,27,68,23,34,92
L.A. Lakers,72,"March 24, 2017",Minnesota,1,1,130,119,1,53,130,42,26,6,2,20,23,33,9,46,88,14,23,32,65,24,28,140
Minnesota,72,"March 25, 2017",Portland,0,0,100,112,1,48,100,27,15,10,4,8,14,21,6,37,75,2,10,35,65,24,32,102
Toronto,72,"March 23, 2017",Miami,0,1,101,84,1,48,101,51,10,9,3,17,21,40,11,35,79,6,23,29,56,25,32,106
L.A. Clippers,72,"March 21, 2017",L.A.Lakers,0,1,133,109,1,48,133,48,23,4,4,15,21,35,13,45,84,15,33,30,51,28,32,154
Denver,72,"March 24, 2017",Indiana,0,1,125,117,1,48,125,46,23,8,4,13,15,35,11,39,82,7,27,32,55,40,43,147
Toronto,73,"March 25, 2017",Dallas,0,1,94,86,1,48,94,44,22,9,3,14,21,32,12,39,81,9,21,30,60,7,9,114
Cleveland,73,"March 27, 2017",San Antonio,0,0,74,103,1,48,74,40,20,8,2,16,20,31,9,31,83,4,26,27,57,8,13,71
Orlando,73,"March 24, 2017",Detroit,1,1,115,87,1,48,115,47,36,4,6,10,17,41,6,47,91,12,26,35,65,9,13,150
Sacramento,73,"March 26, 2017",L.A.Clippers,0,1,98,97,1,48,98,46,23,5,4,12,25,40,6,38,84,13,28,25,56,9,13,114
New Orleans,73,"March 26, 2017",Denver,0,1,115,90,1,48,115,59,29,7,4,9,18,49,10,48,97,9,27,39,70,10,12,154
Philadelphia,73,"March 26, 2017",Indiana,0,0,94,107,1,48,94,48,19,7,5,14,23,40,8,35,88,14,41,21,47,10,14,102
Memphis,73,"March 26, 2017",Golden State,0,0,94,106,1,48,94,37,21,11,0,13,13,24,13,38,85,8,29,30,56,10,15,98
L.A. Lakers,73,"March 26, 2017",Portland,1,0,81,97,1,48,81,42,19,7,3,10,17,41,1,33,84,5,21,28,63,10,17,84
Golden State,73,"March 26, 2017",Memphis,1,1,106,94,1,48,106,38,30,9,4,18,15,30,8,39,72,17,31,22,41,11,15,132
Oklahoma City,73,"March 27, 2017",Dallas,0,1,92,91,1,48,92,48,17,10,7,17,21,37,11,37,85,6,23,31,62,12,14,107
Denver,73,"March 26, 2017",New Orleans,1,0,90,115,1,48,90,49,21,3,1,10,13,41,8,36,95,6,25,30,70,12,14,93
New York,73,"March 25, 2017",San Antonio,0,0,98,106,1,48,98,45,24,6,5,16,16,33,12,41,87,3,10,38,77,13,15,114
Milwaukee,73,"March 26, 2017",Chicago,1,0,94,109,1,48,94,34,20,8,0,9,9,25,9,37,84,7,23,30,61,13,17,96
Utah,73,"March 25, 2017",L.A.Clippers,0,0,95,108,1,48,95,43,22,5,3,14,22,31,12,37,86,8,26,29,60,13,18,100
Portland,73,"March 26, 2017",L.A.Lakers,0,1,97,81,1,48,97,61,24,8,4,13,16,49,12,36,89,12,28,24,61,13,18,123
San Antonio,73,"March 27, 2017",Cleveland,1,1,103,74,1,48,103,52,24,11,7,12,18,42,10,41,86,7,26,34,60,14,17,137
L.A. Clippers,73,"March 23, 2017",Dallas,0,0,95,97,1,48,95,45,18,6,2,17,16,36,9,36,80,9,27,27,53,14,21,98
Dallas,73,"March 27, 2017",Oklahoma City,1,0,91,92,1,48,91,39,23,12,4,14,16,31,8,33,80,10,29,23,51,15,19,104
Detroit,73,"March 24, 2017",Orlando,0,0,87,115,1,48,87,50,21,3,3,8,17,38,12,34,96,2,22,32,74,17,20,91
Houston,73,"March 26, 2017",Oklahoma City,1,1,137,125,1,48,137,36,32,8,4,19,23,34,2,50,79,20,39,30,40,17,21,165
Miami,73,"March 26, 2017",Boston,0,0,108,112,1,48,108,40,19,9,5,15,22,24,16,41,91,7,29,34,62,19,24,111
Atlanta,73,"March 26, 2017",Brooklyn,1,0,92,107,1,48,92,58,16,10,3,20,19,32,26,34,98,5,27,29,71,19,32,82
Washington,73,"March 25, 2017",Cleveland,0,1,127,115,1,48,127,40,24,10,4,11,23,29,11,49,82,8,18,41,64,21,26,156
Charlotte,73,"March 26, 2017",Phoenix,1,1,120,106,1,48,120,41,29,8,2,7,14,33,8,42,87,14,30,28,57,22,24,146
Chicago,73,"March 24, 2017",Philadelphia,1,0,107,117,1,48,107,39,22,9,5,14,15,24,15,37,91,10,24,27,67,23,31,106
Indiana,73,"March 26, 2017",Philadelphia,1,1,107,94,1,48,107,51,16,9,4,9,13,39,12,38,89,7,17,31,72,24,29,122
Brooklyn,73,"March 26, 2017",Atlanta,0,1,107,92,1,48,107,50,21,13,7,17,25,38,12,38,86,6,22,32,64,25,30,128
Boston,73,"March 24, 2017",Phoenix,1,1,130,120,1,48,130,50,31,8,5,15,32,38,12,44,94,14,41,30,53,28,35,152
Minnesota,73,"March 28, 2017",Indiana,0,1,115,114,1,48,115,35,22,10,9,15,22,24,11,37,77,9,20,28,57,32,37,131
Phoenix,73,"March 24, 2017",Boston,0,0,120,130,1,48,120,49,23,9,3,13,30,39,10,39,86,6,19,33,67,36,49,131
Chicago,74,"March 26, 2017",Milwaukee,0,1,109,94,1,48,109,49,33,4,2,14,16,39,10,46,85,10,21,36,64,7,10,141
Cleveland,74,"March 30, 2017",Chicago,0,0,93,99,1,48,93,44,23,6,5,15,22,35,9,37,83,10,27,27,56,9,16,103
Utah,74,"March 27, 2017",New Orleans,1,1,108,100,1,48,108,49,27,6,6,10,22,38,11,41,85,15,27,26,58,11,18,135
New York,74,"March 27, 2017",Detroit,1,1,109,95,1,48,109,37,26,13,5,12,16,33,4,45,84,7,21,38,63,12,13,138
Golden State,74,"March 28, 2017",Houston,0,1,113,106,1,48,113,44,33,9,7,16,29,36,8,45,88,11,41,34,47,12,16,143
Milwaukee,74,"March 28, 2017",Charlotte,0,1,118,108,1,48,118,42,31,1,3,14,26,39,3,46,74,14,30,32,44,12,17,148
L.A. Lakers,74,"March 28, 2017",Washington,1,0,108,119,1,48,108,43,21,6,9,18,19,32,11,43,85,8,22,35,63,14,16,125
Detroit,74,"March 27, 2017",New York,0,0,95,109,1,48,95,42,18,4,3,18,16,30,12,36,84,9,23,27,61,14,21,89
Dallas,74,"March 29, 2017",New Orleans,0,0,118,121,1,48,118,38,25,3,4,5,21,30,8,44,91,14,27,30,64,16,17,135
Denver,74,"March 28, 2017",Portland,0,0,113,122,1,48,113,47,23,3,6,11,24,34,13,44,95,9,30,35,65,16,20,126
Brooklyn,74,"March 28, 2017",Philadelphia,1,0,101,106,1,48,101,50,22,11,5,13,19,37,13,38,94,9,32,29,62,16,24,112
New Orleans,74,"March 27, 2017",Utah,0,0,100,108,1,48,100,37,17,7,7,9,17,32,5,37,80,10,25,27,55,16,24,108
Washington,74,"March 28, 2017",L.A.Lakers,0,1,119,108,1,48,119,41,24,12,3,12,20,28,13,48,94,6,23,42,71,17,25,133
Philadelphia,74,"March 28, 2017",Brooklyn,0,1,106,101,1,48,106,53,21,7,9,16,23,41,12,39,91,10,33,29,58,18,21,125
Phoenix,74,"March 26, 2017",Charlotte,0,0,106,120,1,48,106,39,25,6,3,12,17,31,8,41,81,6,16,35,65,18,22,123
Oklahoma City,74,"March 29, 2017",Orlando,0,1,114,106,1,53,114,57,18,11,7,11,20,46,11,43,102,10,33,33,69,18,28,127
Miami,74,"March 28, 2017",Detroit,0,1,97,96,1,48,97,44,18,5,4,12,18,33,11,36,79,5,21,31,58,20,28,105
San Antonio,74,"March 29, 2017",Golden State,1,0,98,110,1,48,98,42,20,9,8,15,12,26,16,34,83,9,24,25,59,21,26,108
Atlanta,74,"March 28, 2017",Phoenix,1,1,95,91,1,48,95,51,24,5,6,19,23,42,9,34,85,6,27,28,58,21,29,103
Boston,74,"March 26, 2017",Miami,1,1,112,108,1,48,112,35,32,8,3,16,19,27,8,41,77,8,24,33,53,22,25,135
Orlando,74,"March 27, 2017",Toronto,0,0,112,131,1,48,112,33,19,11,3,11,23,25,8,43,88,4,20,39,68,22,28,116
Memphis,74,"March 27, 2017",Sacramento,0,0,90,91,1,48,90,45,15,4,2,7,18,26,19,31,90,5,26,26,64,23,29,84
Charlotte,74,"March 28, 2017",Milwaukee,1,0,108,118,1,48,108,31,25,7,1,2,12,26,5,39,80,7,28,32,52,23,29,123
Sacramento,74,"March 27, 2017",Memphis,1,1,91,90,1,48,91,36,16,4,6,11,23,28,8,31,67,6,25,25,42,23,30,99
Minnesota,74,"March 30, 2017",L.A.Lakers,1,1,119,104,1,48,119,40,30,9,5,10,20,26,14,43,89,10,21,33,68,23,30,140
Toronto,74,"March 27, 2017",Orlando,1,1,131,112,1,48,131,43,24,7,8,15,25,34,9,49,83,10,15,39,68,23,35,152
Portland,74,"March 28, 2017",Denver,1,1,122,113,1,48,122,48,15,7,6,9,18,32,16,45,91,8,27,37,64,24,33,134
L.A. Clippers,74,"March 25, 2017",Utah,1,1,108,95,1,48,108,48,14,9,5,10,17,36,12,38,85,7,27,31,58,25,28,124
Indiana,74,"March 28, 2017",Minnesota,1,0,114,115,1,48,114,37,25,9,4,14,22,25,12,40,81,5,18,35,63,29,35,128
Houston,74,"March 28, 2017",Golden State,1,0,106,113,1,48,106,38,20,9,2,14,14,28,10,33,85,5,31,28,54,35,39,105
Denver,75,"March 31, 2017",Charlotte,0,0,114,122,1,48,114,49,32,4,1,13,19,39,10,45,90,16,33,29,57,8,11,139
Philadelphia,75,"March 29, 2017",Atlanta,1,0,92,99,1,48,92,40,30,7,3,14,19,27,13,36,87,11,39,25,48,9,11,105
Brooklyn,75,"March 30, 2017",Detroit,0,0,89,90,1,48,89,46,17,4,4,12,16,38,8,35,92,10,31,25,61,9,12,88
Cleveland,75,"March 31, 2017",Philadelphia,1,1,122,105,1,48,122,49,30,8,4,8,16,36,13,50,95,13,29,37,66,9,16,153
Golden State,75,"March 29, 2017",San Antonio,0,1,110,98,1,48,110,34,31,7,7,15,22,25,9,43,84,13,26,30,58,11,11,133
Chicago,75,"March 30, 2017",Cleveland,1,1,99,93,1,48,99,51,26,11,3,12,15,36,15,38,90,12,25,26,65,11,18,119
Sacramento,75,"March 29, 2017",Utah,1,0,82,112,1,48,82,32,14,7,1,13,17,30,2,34,75,2,15,32,60,12,18,76
Indiana,75,"March 29, 2017",Memphis,0,0,97,110,1,48,97,43,19,5,7,12,18,31,12,37,85,10,25,27,60,13,15,109
Milwaukee,75,"March 29, 2017",Boston,0,1,103,100,1,48,103,35,27,9,8,14,21,28,7,41,78,8,22,33,56,13,17,127
Miami,75,"March 29, 2017",New York,0,1,105,88,1,48,105,40,18,11,7,10,23,32,8,40,84,12,25,28,59,13,17,123
Phoenix,75,"March 28, 2017",Atlanta,0,0,91,95,1,48,91,48,25,12,6,15,31,34,14,35,96,7,31,28,65,14,24,96
L.A. Lakers,75,"March 30, 2017",Minnesota,0,0,104,119,1,48,104,42,20,4,5,16,22,28,14,40,84,9,27,31,57,15,16,114
Utah,75,"March 29, 2017",Sacramento,0,1,112,82,1,48,112,43,22,10,3,11,18,36,7,42,79,13,32,29,47,15,19,138
Memphis,75,"March 29, 2017",Indiana,1,1,110,97,1,48,110,43,22,8,3,8,19,34,9,41,88,12,32,29,56,16,18,129
Detroit,75,"March 28, 2017",Miami,1,0,96,97,1,48,96,51,20,7,5,12,23,35,16,36,85,8,27,28,58,16,21,113
Charlotte,75,"March 29, 2017",Toronto,0,1,110,106,1,48,110,38,23,6,2,8,18,27,11,39,86,16,32,23,54,16,21,119
New York,75,"March 29, 2017",Miami,1,0,88,105,1,48,88,52,19,2,6,14,16,35,17,33,89,5,25,28,64,17,21,93
San Antonio,75,"March 31, 2017",Oklahoma City,0,1,100,95,1,48,100,41,23,8,11,13,23,28,13,37,85,9,27,28,58,17,27,112
Portland,75,"March 30, 2017",Houston,1,1,117,107,1,48,117,41,24,12,8,12,16,30,11,43,90,13,33,30,57,18,22,139
Boston,75,"March 29, 2017",Milwaukee,1,0,100,103,1,48,100,42,24,8,3,16,18,27,15,35,88,12,37,23,51,18,23,103
Houston,75,"March 30, 2017",Portland,0,0,107,117,1,48,107,42,18,9,3,18,20,29,13,40,91,8,34,32,57,19,23,106
Toronto,75,"March 29, 2017",Charlotte,1,0,106,110,1,48,106,44,23,4,7,13,22,31,13,38,83,11,31,27,52,19,24,121
Orlando,75,"March 29, 2017",Oklahoma City,1,0,106,114,1,53,106,53,24,9,8,14,22,42,11,39,97,9,30,30,67,19,27,120
Washington,75,"March 29, 2017",L.A.Clippers,0,0,124,133,1,48,124,43,22,7,0,10,31,29,14,46,93,13,34,33,59,19,29,129
Dallas,75,"March 31, 2017",Memphis,0,0,90,99,1,48,90,38,15,7,4,8,21,32,6,29,76,12,34,17,42,20,25,94
Atlanta,75,"March 29, 2017",Philadelphia,0,1,99,92,1,48,99,47,19,7,3,17,15,32,15,34,80,9,18,25,62,22,26,108
Oklahoma City,75,"March 31, 2017",San Antonio,1,0,95,100,1,48,95,46,21,7,3,18,21,33,13,33,81,6,21,27,60,23,27,102
L.A. Clippers,75,"March 26, 2017",Sacramento,1,0,97,98,1,48,97,45,20,7,2,9,14,39,6,32,78,10,29,22,49,23,28,111
New Orleans,75,"March 29, 2017",Dallas,1,1,121,118,1,48,121,43,26,5,5,6,18,33,10,42,83,12,30,30,53,25,33,145
Minnesota,75,"April 1, 2017",Sacramento,1,0,117,123,1,48,117,41,27,8,4,10,23,31,10,39,87,9,25,30,62,30,38,131
Golden State,76,"March 31, 2017",Houston,1,1,107,98,1,48,107,43,27,10,14,10,20,30,13,43,95,11,32,32,63,10,14,135
Oklahoma City,76,"April 2, 2017",Charlotte,1,0,101,113,1,48,101,42,19,10,5,24,20,35,7,39,84,12,31,27,53,11,12,107
Detroit,76,"March 30, 2017",Brooklyn,1,1,90,89,1,48,90,53,20,6,7,16,11,42,11,36,86,7,18,29,68,11,17,104
Washington,76,"March 31, 2017",Utah,0,0,88,95,1,48,88,45,12,8,1,14,23,31,14,35,87,5,17,30,70,13,16,85
Brooklyn,76,"April 1, 2017",Orlando,1,1,121,111,1,48,121,44,26,8,5,11,15,35,9,50,94,8,31,42,63,13,16,146
Sacramento,76,"March 31, 2017",New Orleans,0,0,89,117,1,48,89,52,18,7,6,21,17,38,14,35,89,6,19,29,70,13,17,93
Atlanta,76,"April 1, 2017",Chicago,0,0,104,106,1,48,104,45,25,4,2,13,16,34,11,40,90,11,28,29,62,13,17,113
Phoenix,76,"March 30, 2017",L.A.Clippers,1,0,118,124,1,48,118,43,24,6,2,14,27,30,13,49,92,7,23,42,69,13,24,125
Chicago,76,"April 1, 2017",Atlanta,1,1,106,104,1,48,106,40,25,6,4,12,17,34,6,40,85,12,30,28,55,14,14,124
Philadelphia,76,"March 31, 2017",Cleveland,0,0,105,122,1,48,105,42,26,7,2,17,21,35,7,40,82,11,33,29,49,14,19,118
New Orleans,76,"March 31, 2017",Sacramento,1,1,117,89,1,48,117,44,28,17,13,12,13,34,10,46,95,10,33,36,62,15,19,154
New York,76,"March 31, 2017",Miami,0,1,98,94,1,48,98,39,25,9,5,14,18,31,8,38,80,6,16,32,64,16,17,119
Indiana,76,"March 31, 2017",Toronto,0,0,100,111,1,48,100,42,19,7,4,13,21,30,12,36,87,11,26,25,61,17,21,104
Memphis,76,"March 31, 2017",Dallas,1,1,99,90,1,48,99,47,23,4,4,13,22,39,8,35,75,11,27,24,48,18,20,122
Houston,76,"March 31, 2017",Golden State,0,0,98,107,1,48,98,49,20,6,3,13,12,30,19,34,92,12,37,22,55,18,23,100
Miami,76,"March 31, 2017",New York,1,0,94,98,1,48,94,41,17,5,4,13,17,30,11,34,83,8,33,26,50,18,25,92
Dallas,76,"April 2, 2017",Milwaukee,0,1,109,105,1,48,109,30,25,7,1,13,18,26,4,38,73,14,36,24,37,19,20,123
San Antonio,76,"April 2, 2017",Utah,1,1,109,103,1,48,109,42,26,7,6,13,17,34,8,40,77,10,19,30,58,19,22,137
Utah,76,"March 31, 2017",Washington,1,1,95,88,1,48,95,42,20,9,7,10,18,35,7,33,72,10,25,23,47,19,31,112
L.A. Lakers,76,"April 1, 2017",L.A.Clippers,0,0,104,115,1,48,104,41,26,12,2,11,27,26,15,39,90,6,23,33,67,20,30,113
Denver,76,"April 2, 2017",Miami,0,1,116,113,1,48,116,39,25,10,6,8,14,33,6,44,87,5,20,39,67,23,27,141
Cleveland,76,"April 2, 2017",Indiana,1,1,135,130,1,58,135,56,29,7,4,13,19,41,15,47,95,18,43,29,52,23,33,160
Toronto,76,"March 31, 2017",Indiana,1,1,111,100,1,48,111,53,23,7,5,14,23,37,16,37,82,14,27,23,55,23,35,128
Orlando,76,"March 31, 2017",Boston,0,0,116,117,1,48,116,48,28,9,4,9,21,37,11,40,98,12,30,28,68,24,25,137
Minnesota,76,"April 3, 2017",Portland,1,1,110,109,1,48,110,43,26,3,5,11,18,32,11,41,83,4,9,37,74,24,28,130
Milwaukee,76,"March 31, 2017",Detroit,1,1,108,105,1,53,108,48,25,6,3,12,18,39,9,35,84,14,36,21,48,24,34,119
Charlotte,76,"March 31, 2017",Denver,1,1,122,114,1,48,122,43,26,10,11,6,17,33,10,40,86,17,36,23,50,25,30,155
L.A. Clippers,76,"March 29, 2017",Washington,1,1,133,124,1,48,133,41,27,6,4,10,22,33,8,47,83,12,30,35,53,27,37,155
Portland,76,"April 1, 2017",Phoenix,1,1,130,117,1,48,130,41,21,12,3,12,23,30,11,43,92,15,37,28,55,29,31,144
Boston,76,"March 31, 2017",Orlando,1,1,117,116,1,48,117,45,27,6,5,11,18,40,5,38,84,12,33,26,51,29,34,138
Utah,77,"April 2, 2017",San Antonio,0,0,103,109,1,48,103,36,24,6,8,10,18,24,12,43,89,9,24,34,65,8,13,116
Memphis,77,"April 2, 2017",L.A.Lakers,0,0,103,108,1,48,103,33,29,8,5,14,19,28,5,40,80,13,30,27,50,10,14,120
Detroit,77,"March 31, 2017",Milwaukee,0,0,105,108,1,53,105,54,25,8,4,12,27,41,13,44,97,7,30,37,67,10,16,125
Dallas,77,"April 4, 2017",Sacramento,0,0,87,98,1,48,87,39,21,9,8,16,13,31,8,32,80,12,43,20,37,11,14,97
Orlando,77,"April 1, 2017",Brooklyn,0,0,111,121,1,48,111,42,26,9,2,14,15,31,11,45,91,10,25,35,66,11,15,126
San Antonio,77,"April 4, 2017",Memphis,1,1,95,89,1,53,95,46,22,8,6,15,20,38,8,35,80,11,21,24,59,14,18,113
Chicago,77,"April 2, 2017",New Orleans,0,1,117,110,1,48,117,49,26,7,6,11,23,40,9,45,92,13,26,32,66,14,18,143
Milwaukee,77,"April 2, 2017",Dallas,1,0,105,109,1,48,105,33,25,9,3,13,20,29,4,39,77,12,34,27,43,15,18,121
Toronto,77,"April 2, 2017",Philadelphia,1,1,113,105,1,48,113,37,25,12,9,15,19,27,10,46,85,6,19,40,66,15,19,138
Denver,77,"April 4, 2017",New Orleans,0,1,134,131,1,48,134,50,31,3,2,10,20,35,15,53,99,13,30,40,69,15,21,158
Atlanta,77,"April 2, 2017",Brooklyn,0,0,82,91,1,48,82,44,19,9,4,19,19,36,8,30,80,7,24,23,56,15,23,81
Houston,77,"April 2, 2017",Phoenix,0,1,123,116,1,48,123,46,23,8,4,15,23,33,13,47,100,14,38,33,62,15,23,128
Miami,77,"April 2, 2017",Denver,1,0,113,116,1,48,113,41,26,3,9,11,22,34,7,42,86,13,26,29,60,16,21,132
Cleveland,77,"April 4, 2017",Orlando,1,1,122,102,1,48,122,42,30,9,3,12,18,37,5,44,82,18,36,26,46,16,21,151
Brooklyn,77,"April 2, 2017",Atlanta,1,1,91,82,1,48,91,51,21,11,7,19,22,43,8,32,82,10,33,22,49,17,20,109
Indiana,77,"April 2, 2017",Cleveland,0,0,130,135,1,58,130,46,32,6,3,9,24,34,12,48,105,16,41,32,64,18,20,149
Boston,77,"April 2, 2017",New York,0,1,110,94,1,48,110,41,22,8,3,17,25,36,5,40,72,12,37,28,35,18,26,127
Washington,77,"April 2, 2017",Golden State,0,0,115,139,1,48,115,38,28,10,4,14,20,29,9,43,92,10,27,33,65,19,25,126
New York,77,"April 2, 2017",Boston,1,0,94,110,1,48,94,32,20,12,2,11,20,24,8,33,85,7,25,26,60,21,25,93
Oklahoma City,77,"April 4, 2017",Milwaukee,1,1,110,79,1,48,110,53,29,9,8,13,20,42,11,40,84,9,28,31,56,21,25,148
Minnesota,77,"April 4, 2017",Golden State,0,0,107,121,1,48,107,50,22,9,3,13,19,31,19,41,96,4,19,37,77,21,26,118
L.A. Lakers,77,"April 2, 2017",Memphis,1,1,108,103,1,48,108,51,14,11,2,13,12,34,17,40,85,7,19,33,66,21,27,122
Portland,77,"April 3, 2017",Minnesota,0,0,109,110,1,48,109,35,24,7,9,5,18,24,11,38,86,11,32,27,54,22,25,128
Philadelphia,77,"April 2, 2017",Toronto,0,0,105,113,1,48,105,37,25,8,5,19,20,24,13,36,80,11,36,25,44,22,25,114
Golden State,77,"April 2, 2017",Washington,1,1,139,115,1,48,139,45,34,7,10,17,20,34,11,50,89,16,36,34,53,23,26,176
Sacramento,77,"April 1, 2017",Minnesota,0,1,123,117,1,48,123,40,27,5,4,17,27,33,7,44,78,11,19,33,59,24,33,139
L.A. Clippers,77,"March 30, 2017",Phoenix,0,1,124,118,1,48,124,39,20,4,4,14,21,32,7,44,80,12,22,32,58,24,34,131
Phoenix,77,"April 1, 2017",Portland,0,0,117,130,1,48,117,43,17,8,6,17,26,30,13,44,84,3,10,41,74,26,32,128
Charlotte,77,"April 2, 2017",Oklahoma City,0,1,113,101,1,48,113,37,20,18,5,16,13,34,3,37,77,11,30,26,47,28,32,133
New Orleans,77,"April 2, 2017",Chicago,1,0,110,117,1,48,110,40,24,7,4,12,14,34,6,33,81,10,30,23,51,34,35,124
San Antonio,78,"April 5, 2017",L.A.Lakers,1,0,95,102,1,48,95,37,28,8,8,14,13,30,7,39,89,13,35,26,54,4,6,110
New York,78,"April 4, 2017",Chicago,1,1,100,91,1,48,100,53,26,5,7,15,22,37,16,42,88,6,23,36,65,10,16,124
Miami,78,"April 5, 2017",Charlotte,0,1,112,99,1,48,112,40,23,5,7,6,16,33,7,40,84,21,40,19,44,11,12,136
L.A. Lakers,78,"April 5, 2017",San Antonio,0,1,102,95,1,48,102,47,23,8,5,16,13,39,8,42,86,7,14,35,72,11,14,122
Detroit,78,"April 5, 2017",Toronto,1,0,102,105,1,48,102,45,22,5,4,15,21,33,12,42,80,7,21,35,59,11,18,118
Memphis,78,"April 4, 2017",San Antonio,0,0,89,95,1,53,89,50,26,9,2,15,20,38,12,35,89,8,25,27,64,11,18,100
Sacramento,78,"April 4, 2017",Dallas,1,1,98,87,1,48,98,50,17,11,2,18,10,40,10,36,80,12,22,24,58,14,17,113
Dallas,78,"April 5, 2017",L.A.Clippers,0,0,101,112,1,48,101,44,24,5,3,16,26,33,11,38,86,11,31,27,55,14,18,109
Portland,78,"April 4, 2017",Utah,0,0,87,106,1,48,87,28,10,9,4,7,20,21,7,33,83,6,26,27,57,15,17,79
New Orleans,78,"April 4, 2017",Denver,1,0,131,134,1,48,131,35,30,5,9,7,16,25,10,51,100,14,32,37,68,15,17,152
Denver,78,"April 5, 2017",Houston,0,0,104,110,1,48,104,51,26,10,5,12,24,39,12,41,104,7,38,34,66,15,18,118
Washington,78,"April 4, 2017",Charlotte,1,1,118,111,1,48,118,36,31,10,3,12,18,30,6,43,84,17,34,26,50,15,18,142
Utah,78,"April 4, 2017",Portland,1,1,106,87,1,48,106,47,21,4,6,15,16,40,7,39,73,13,23,26,50,15,19,131
Oklahoma City,78,"April 5, 2017",Memphis,0,1,103,100,1,48,103,44,19,8,4,12,20,32,12,37,85,14,31,23,54,15,24,109
Cleveland,78,"April 5, 2017",Boston,0,1,114,91,1,48,114,51,19,7,5,10,26,38,13,43,92,11,36,32,56,17,18,136
Toronto,78,"April 4, 2017",Indiana,0,0,90,108,1,48,90,40,11,7,5,13,19,34,6,34,76,5,23,29,53,17,19,96
Indiana,78,"April 4, 2017",Toronto,1,1,108,90,1,48,108,43,16,7,4,11,17,33,10,39,89,12,25,27,64,18,18,117
Minnesota,78,"April 6, 2017",Portland,0,0,98,105,1,48,98,47,16,7,4,13,20,38,9,38,87,4,18,34,69,18,20,108
Milwaukee,78,"April 4, 2017",Oklahoma City,0,0,79,110,1,48,79,38,16,9,5,11,19,28,10,29,81,3,18,26,63,18,26,76
Boston,78,"April 5, 2017",Cleveland,1,0,91,114,1,48,91,38,21,6,4,12,18,30,8,33,81,7,33,26,48,18,29,89
Charlotte,78,"April 4, 2017",Washington,0,0,111,118,1,48,111,36,21,5,2,16,17,28,8,40,78,12,34,28,44,19,22,118
Golden State,78,"April 4, 2017",Minnesota,1,1,121,107,1,48,121,40,33,9,7,13,19,32,8,44,84,14,32,30,52,19,24,152
Philadelphia,78,"April 4, 2017",Brooklyn,1,0,118,141,1,48,118,36,32,7,4,11,22,22,14,43,97,12,38,31,59,20,27,125
Chicago,78,"April 4, 2017",New York,0,0,91,100,1,48,91,36,22,8,4,15,15,25,11,32,84,6,27,26,57,21,23,92
Phoenix,78,"April 2, 2017",Houston,1,0,116,123,1,48,116,61,24,8,12,23,24,39,22,42,100,8,34,34,66,24,29,135
Atlanta,78,"April 6, 2017",Boston,1,1,123,116,1,48,123,52,26,7,4,17,30,39,13,44,89,11,23,33,66,24,34,140
Orlando,78,"April 4, 2017",Cleveland,0,0,102,122,1,48,102,43,23,8,3,14,21,32,11,33,86,11,33,22,53,25,26,111
Houston,78,"April 5, 2017",Denver,1,1,110,104,1,48,110,56,19,7,3,16,20,45,11,37,87,10,34,27,53,26,38,117
L.A. Clippers,78,"April 1, 2017",L.A.Lakers,1,1,115,104,1,48,115,39,24,8,5,17,19,35,4,38,69,11,25,27,44,28,34,137
Brooklyn,78,"April 4, 2017",Philadelphia,0,1,141,118,1,48,141,36,36,9,5,17,18,35,1,48,75,16,31,32,44,29,33,179
Dallas,79,"April 7, 2017",San Antonio,1,0,89,102,1,48,89,44,26,1,8,9,17,38,6,38,88,8,27,30,61,5,8,106
Atlanta,79,"April 7, 2017",Cleveland,0,1,114,100,1,48,114,42,39,7,3,11,17,36,6,45,89,16,37,29,52,8,8,150
New Orleans,79,"April 7, 2017",Denver,0,0,106,122,1,48,106,33,19,11,3,11,19,23,10,47,99,3,23,44,76,9,13,105
Sacramento,79,"April 7, 2017",L.A.Lakers,0,0,94,98,1,48,94,40,27,5,7,23,19,30,10,38,75,8,20,30,55,10,13,110
Milwaukee,79,"April 6, 2017",Indiana,0,0,89,104,1,48,89,32,21,8,4,21,22,26,6,33,71,11,24,22,47,12,14,93
Toronto,79,"April 5, 2017",Detroit,0,1,105,102,1,48,105,35,29,8,1,11,14,28,7,41,87,10,30,31,57,13,15,119
Detroit,79,"April 7, 2017",Houston,0,1,114,109,1,48,114,55,27,5,1,6,17,37,18,46,108,9,26,37,82,13,16,131
Cleveland,79,"April 7, 2017",Atlanta,1,0,100,114,1,48,100,38,23,5,3,13,10,35,3,39,81,9,36,30,45,13,17,110
San Antonio,79,"April 7, 2017",Dallas,0,1,102,89,1,48,102,58,26,6,5,6,11,42,16,40,96,9,28,31,68,13,22,126
Chicago,79,"April 6, 2017",Philadelphia,0,1,102,90,1,48,102,57,27,7,6,16,19,47,10,39,91,8,25,31,66,16,17,130
New York,79,"April 6, 2017",Washington,1,0,103,106,1,48,103,49,20,9,2,11,19,29,20,40,95,7,20,33,75,16,21,112
Brooklyn,79,"April 6, 2017",Orlando,0,0,107,115,1,48,107,39,21,7,6,14,19,32,7,40,87,11,30,29,57,16,22,113
Utah,79,"April 7, 2017",Minnesota,1,1,120,113,1,48,120,33,29,8,7,14,21,27,6,45,75,14,25,31,50,16,22,147
Memphis,79,"April 5, 2017",Oklahoma City,1,0,100,103,1,48,100,38,21,7,5,13,18,31,7,37,78,9,26,28,52,17,21,113
Philadelphia,79,"April 6, 2017",Chicago,1,0,90,102,1,48,90,50,19,10,3,13,19,40,10,33,91,7,33,26,58,17,22,96
Golden State,79,"April 5, 2017",Phoenix,0,1,120,111,1,48,120,40,25,13,9,15,19,32,8,45,90,13,31,32,59,17,24,140
L.A. Lakers,79,"April 7, 2017",Sacramento,1,1,98,94,1,48,98,41,20,12,1,14,15,25,16,38,86,4,24,34,62,18,25,103
Phoenix,79,"April 5, 2017",Golden State,1,0,111,120,1,48,111,55,26,13,3,16,22,35,20,43,103,7,27,36,76,18,26,124
Indiana,79,"April 6, 2017",Milwaukee,1,1,104,89,1,48,104,44,20,15,3,16,12,32,12,38,80,8,25,30,55,20,26,122
Washington,79,"April 6, 2017",New York,0,1,106,103,1,48,106,39,17,5,8,13,22,30,9,36,74,14,34,22,40,20,28,116
Miami,79,"April 7, 2017",Toronto,0,0,94,96,1,48,94,44,16,10,5,19,21,30,14,33,83,8,23,25,60,20,29,91
Charlotte,79,"April 5, 2017",Miami,1,0,99,112,1,48,99,36,19,2,7,6,15,32,4,35,78,8,25,27,53,21,24,111
Portland,79,"April 6, 2017",Minnesota,1,1,105,98,1,48,105,41,19,8,4,12,20,37,4,35,81,14,33,21,48,21,26,114
Houston,79,"April 7, 2017",Detroit,1,0,109,114,1,48,109,49,25,3,6,11,15,40,9,36,87,16,51,20,36,21,28,123
Orlando,79,"April 6, 2017",Brooklyn,1,1,115,107,1,48,115,48,24,9,5,13,20,39,9,42,90,9,25,33,65,22,26,136
Denver,79,"April 7, 2017",New Orleans,1,1,122,106,1,48,122,50,31,9,4,21,15,39,11,43,78,13,32,30,46,23,32,151
L.A. Clippers,79,"April 5, 2017",Dallas,1,1,112,101,1,48,112,40,22,11,0,14,19,35,5,38,75,12,31,26,44,24,31,127
Oklahoma City,79,"April 7, 2017",Phoenix,0,0,99,120,1,48,99,48,13,1,3,9,26,26,22,34,93,7,31,27,62,24,33,87
Boston,79,"April 6, 2017",Atlanta,0,0,116,123,1,48,116,38,28,9,4,12,29,28,10,37,90,15,43,22,47,27,34,123
Minnesota,79,"April 7, 2017",Utah,0,0,113,120,1,48,113,34,22,11,1,12,25,25,9,39,79,7,16,32,63,28,28,129
New York,80,"April 7, 2017",Memphis,0,0,88,101,1,48,88,41,20,8,4,6,16,26,15,38,88,6,28,32,60,6,13,98
L.A. Clippers,80,"April 8, 2017",San Antonio,0,1,98,87,1,48,98,45,21,8,7,6,15,37,8,42,84,6,22,36,62,8,14,125
Memphis,80,"April 7, 2017",New York,1,1,101,88,1,48,101,38,20,3,9,12,14,31,7,38,75,15,27,23,48,10,12,120
San Antonio,80,"April 8, 2017",L.A.Clippers,1,0,87,98,1,48,87,40,20,3,4,13,17,33,7,34,80,8,22,26,58,11,14,92
Detroit,80,"April 9, 2017",Memphis,0,1,103,90,1,48,103,46,21,8,2,18,12,31,15,39,82,14,28,25,54,11,16,114
New Orleans,80,"April 8, 2017",Golden State,0,0,101,123,1,48,101,34,24,3,1,8,15,28,6,42,86,5,21,37,65,12,19,104
Dallas,80,"April 9, 2017",Phoenix,0,0,111,124,1,48,111,44,23,5,2,10,23,27,17,41,97,16,45,25,52,13,19,113
Denver,80,"April 9, 2017",Oklahoma City,1,0,105,106,1,48,105,42,22,6,4,12,16,38,4,40,84,11,34,29,50,14,15,122
Portland,80,"April 8, 2017",Utah,1,1,101,86,1,48,101,46,15,6,5,3,16,34,12,37,91,13,30,24,61,14,16,114
Boston,80,"April 8, 2017",Charlotte,0,1,121,114,1,48,121,43,35,2,5,9,19,38,5,45,87,17,39,28,48,14,17,152
Indiana,80,"April 8, 2017",Orlando,0,1,127,112,1,48,127,45,35,6,5,15,15,39,6,51,86,11,22,40,64,14,19,163
Milwaukee,80,"April 8, 2017",Philadelphia,0,1,90,82,1,48,90,43,18,10,4,15,21,37,6,35,79,6,27,29,52,14,20,100
Golden State,80,"April 8, 2017",New Orleans,1,1,123,101,1,48,123,53,37,2,3,9,15,39,14,49,96,10,33,39,63,15,16,161
Chicago,80,"April 8, 2017",Brooklyn,0,0,106,107,1,48,106,52,14,6,6,17,20,41,11,40,90,11,24,29,66,15,17,115
L.A. Lakers,80,"April 9, 2017",Minnesota,1,1,110,109,1,48,110,40,26,10,8,16,23,28,12,42,86,10,27,32,59,16,20,130
Cleveland,80,"April 9, 2017",Atlanta,0,0,125,126,1,53,125,53,28,4,3,14,27,40,13,45,98,19,46,26,52,16,20,142
Orlando,80,"April 8, 2017",Indiana,1,0,112,127,1,48,112,33,29,10,2,13,16,29,4,41,84,14,30,27,54,16,22,124
Washington,80,"April 8, 2017",Miami,1,0,103,106,1,48,103,44,21,7,6,19,24,32,12,39,81,8,22,31,59,17,22,115
Toronto,80,"April 7, 2017",Miami,1,1,96,94,1,48,96,44,14,10,4,15,24,32,12,35,85,9,20,26,65,17,24,96
Utah,80,"April 8, 2017",Portland,0,0,86,101,1,48,86,47,19,2,9,11,18,38,9,31,77,6,19,25,58,18,24,100
Brooklyn,80,"April 8, 2017",Chicago,1,1,107,106,1,48,107,44,24,15,6,13,13,34,10,39,92,10,31,29,61,19,24,125
Oklahoma City,80,"April 9, 2017",Denver,0,1,106,105,1,48,106,54,19,7,3,12,19,36,18,40,96,6,25,34,71,20,22,119
Philadelphia,80,"April 8, 2017",Milwaukee,1,0,82,90,1,48,82,47,23,9,1,17,16,37,10,27,77,8,31,19,46,20,23,92
Sacramento,80,"April 9, 2017",Houston,1,0,128,135,1,48,128,38,26,8,2,5,18,31,7,47,94,9,31,38,63,25,30,145
Miami,80,"April 8, 2017",Washington,0,1,106,103,1,48,106,36,23,13,7,13,19,28,8,37,80,7,18,30,62,25,36,118
Minnesota,80,"April 9, 2017",L.A.Lakers,0,0,109,110,1,48,109,41,27,8,6,14,16,33,8,40,81,3,16,37,65,26,31,131
Phoenix,80,"April 7, 2017",Oklahoma City,1,1,120,99,1,48,120,45,16,6,6,7,26,33,12,43,83,8,18,35,65,26,31,141
Houston,80,"April 9, 2017",Sacramento,0,1,135,128,1,48,135,41,26,3,2,16,22,36,5,45,80,18,43,27,37,27,31,152
Charlotte,80,"April 8, 2017",Boston,1,0,114,121,1,48,114,42,22,5,5,7,15,35,7,38,84,9,28,29,56,29,32,132
Atlanta,80,"April 9, 2017",Cleveland,1,1,126,125,1,53,126,45,31,8,4,12,22,35,10,44,94,9,31,35,63,29,37,144
Milwaukee,81,"April 10, 2017",Charlotte,1,1,89,79,1,48,89,45,28,4,4,16,14,38,7,35,77,16,28,19,49,3,5,110
Detroit,81,"April 10, 2017",Washington,1,0,101,105,1,48,101,36,22,9,2,10,18,30,6,43,94,10,26,33,68,5,5,109
Charlotte,81,"April 10, 2017",Milwaukee,0,0,79,89,1,48,79,39,21,11,5,9,10,32,7,33,81,5,18,28,63,8,13,93
Dallas,81,"April 11, 2017",Denver,1,0,91,109,1,48,91,42,24,8,4,13,11,34,8,35,88,12,40,23,48,9,11,101
Memphis,81,"April 9, 2017",Detroit,1,0,90,103,1,48,90,30,23,12,3,15,16,24,6,36,75,9,21,27,54,9,13,100
Denver,81,"April 11, 2017",Dallas,0,1,109,91,1,48,109,53,31,7,1,16,14,43,10,41,84,18,42,23,42,9,14,137
Utah,81,"April 10, 2017",Golden State,0,1,105,99,1,48,105,49,29,8,3,11,17,35,14,41,92,13,35,28,57,10,15,127
Orlando,81,"April 10, 2017",Chicago,0,0,75,122,1,48,75,37,18,5,5,16,18,28,9,29,84,5,27,24,57,12,16,65
Golden State,81,"April 10, 2017",Utah,1,0,99,105,1,48,99,42,25,5,6,13,17,34,8,39,80,9,25,30,55,12,17,118
Portland,81,"April 10, 2017",San Antonio,1,1,99,98,1,48,99,42,18,6,3,9,17,30,12,37,90,12,28,25,62,13,15,104
New York,81,"April 9, 2017",Toronto,1,0,97,110,1,48,97,36,27,6,1,11,18,30,6,37,82,9,28,28,54,14,15,110
Washington,81,"April 10, 2017",Detroit,0,1,105,101,1,48,105,48,27,8,6,17,13,39,9,42,83,7,19,35,64,14,16,134
Chicago,81,"April 10, 2017",Orlando,1,1,122,75,1,48,122,54,33,12,4,12,16,43,11,48,89,12,26,36,63,14,16,170
Atlanta,81,"April 11, 2017",Charlotte,1,1,103,76,1,48,103,50,30,6,4,16,17,39,11,41,79,7,27,34,52,14,18,135
San Antonio,81,"April 10, 2017",Portland,0,0,98,99,1,48,98,47,17,4,9,15,15,34,13,38,83,8,21,30,62,14,20,109
New Orleans,81,"April 11, 2017",L.A.Lakers,0,0,96,108,1,48,96,39,29,5,5,16,16,34,5,37,79,7,22,30,57,15,20,111
L.A. Lakers,81,"April 11, 2017",New Orleans,1,1,108,96,1,48,108,47,24,15,3,11,18,39,8,42,88,8,22,34,66,16,23,133
Indiana,81,"April 10, 2017",Philadelphia,0,1,120,111,1,48,120,44,30,9,6,14,23,30,14,49,85,5,16,44,69,17,21,155
Minnesota,81,"April 11, 2017",Oklahoma City,1,0,98,100,1,48,98,35,24,12,3,11,17,24,11,38,86,5,20,33,66,17,25,105
Boston,81,"April 10, 2017",Brooklyn,1,1,114,105,1,48,114,51,31,7,4,13,23,42,9,41,91,14,38,27,53,18,21,141
Cleveland,81,"April 10, 2017",Miami,0,0,121,124,1,53,121,47,19,7,6,21,25,40,7,44,89,14,35,30,54,19,22,131
Oklahoma City,81,"April 11, 2017",Minnesota,0,1,100,98,1,48,100,54,22,7,4,17,21,36,18,37,86,7,22,30,64,19,25,115
Toronto,81,"April 9, 2017",New York,0,1,110,97,1,48,110,40,20,8,1,10,14,36,4,40,76,10,31,30,45,20,23,130
Houston,81,"April 10, 2017",L.A.Clippers,0,0,96,125,1,48,96,41,23,5,3,15,23,32,9,33,84,9,40,24,44,21,27,96
L.A. Clippers,81,"April 10, 2017",Houston,1,1,125,96,1,48,125,49,29,9,0,9,16,37,12,46,91,10,26,36,65,23,28,153
Miami,81,"April 10, 2017",Cleveland,1,1,124,121,1,53,124,46,28,9,6,13,26,37,9,44,95,12,33,32,62,24,34,139
Philadelphia,81,"April 10, 2017",Indiana,1,0,111,120,1,48,111,33,20,10,1,18,19,23,10,35,75,13,33,22,42,28,31,114
Phoenix,81,"April 9, 2017",Dallas,1,1,124,111,1,48,124,43,26,6,4,12,18,35,8,44,80,8,19,36,61,28,32,151
Sacramento,81,"April 11, 2017",Phoenix,1,1,129,104,1,48,129,55,28,7,2,13,23,47,8,43,83,9,19,34,64,34,43,159
Brooklyn,81,"April 10, 2017",Boston,0,0,105,114,1,48,105,49,18,8,7,12,19,40,9,31,86,8,31,23,55,35,39,116
Portland,82,"April 12, 2017",New Orleans,1,0,100,103,1,48,100,53,22,4,2,23,18,39,14,41,85,13,30,28,55,5,13,106
L.A. Lakers,82,"April 12, 2017",Golden State,0,0,94,109,1,48,94,40,23,13,2,18,22,29,11,41,93,4,17,37,76,8,14,96
Miami,82,"April 12, 2017",Washington,1,1,110,102,1,48,110,51,19,2,4,17,13,37,14,46,88,8,24,38,64,10,12,125
Sacramento,82,"April 12, 2017",L.A.Clippers,0,0,95,115,1,48,95,37,27,2,1,10,18,30,7,40,81,5,11,35,70,10,14,107
Toronto,82,"April 12, 2017",Cleveland,0,1,98,83,1,48,98,48,20,8,2,8,20,36,12,40,86,8,26,32,60,10,16,116
San Antonio,82,"April 12, 2017",Utah,0,0,97,101,1,48,97,42,16,12,2,15,17,27,15,39,86,8,21,31,65,11,13,105
Washington,82,"April 12, 2017",Miami,0,0,102,110,1,48,102,34,18,9,0,10,13,26,8,42,87,7,26,35,61,11,14,105
Minnesota,82,"April 12, 2017",Houston,0,0,118,123,1,48,118,49,37,7,3,15,15,39,10,48,91,11,23,37,68,11,15,152
Oklahoma City,82,"April 12, 2017",Denver,1,0,105,111,1,48,105,51,20,10,8,12,24,37,14,43,101,8,25,35,76,11,17,118
Utah,82,"April 12, 2017",San Antonio,1,1,101,97,1,48,101,36,24,10,5,16,16,29,7,39,77,10,26,29,51,13,20,115
Milwaukee,82,"April 12, 2017",Boston,0,0,94,112,1,48,94,43,26,6,9,17,20,34,9,37,84,6,23,31,61,14,17,111
Brooklyn,82,"April 12, 2017",Chicago,0,0,73,112,1,48,73,48,17,8,3,18,16,38,10,28,86,3,33,25,53,14,18,69
Philadelphia,82,"April 12, 2017",New York,0,0,113,114,1,48,113,38,21,10,1,13,25,22,16,46,91,7,23,39,68,14,20,119
Houston,82,"April 12, 2017",Minnesota,1,1,123,118,1,48,123,47,37,11,7,10,14,31,16,45,97,19,56,26,41,14,22,155
Phoenix,82,"April 11, 2017",Sacramento,0,0,104,129,1,48,104,48,19,8,3,9,23,30,18,41,109,8,30,33,79,14,24,95
Charlotte,82,"April 11, 2017",Atlanta,0,0,76,103,1,48,76,40,16,11,1,13,17,25,15,29,88,3,23,26,65,15,19,68
Atlanta,82,"April 12, 2017",Indiana,0,0,86,104,1,48,86,37,19,5,4,18,15,29,8,30,72,11,29,19,43,15,19,87
New Orleans,82,"April 12, 2017",Portland,0,1,103,100,1,48,103,42,20,13,3,11,17,31,11,40,90,8,24,32,66,15,21,114
Golden State,82,"April 12, 2017",L.A.Lakers,1,1,109,94,1,48,109,54,26,14,8,20,17,40,14,41,90,12,36,29,54,15,22,135
Orlando,82,"April 12, 2017",Detroit,1,1,113,109,1,48,113,51,27,7,6,11,22,45,6,42,87,13,25,29,62,16,17,147
Indiana,82,"April 12, 2017",Atlanta,1,1,104,86,1,48,104,41,21,5,7,10,14,33,8,39,82,10,24,29,58,16,19,122
Chicago,82,"April 12, 2017",Brooklyn,1,1,112,73,1,48,112,62,28,15,4,12,18,48,14,41,95,14,30,27,65,16,21,150
Detroit,82,"April 12, 2017",Orlando,0,0,109,113,1,48,109,53,20,6,3,8,15,36,17,41,106,11,35,30,71,16,28,106
Cleveland,82,"April 12, 2017",Toronto,1,0,83,98,1,48,83,43,20,5,7,15,14,33,10,28,76,10,37,18,39,17,24,88
Boston,82,"April 12, 2017",Milwaukee,1,1,112,94,1,48,112,46,31,12,3,8,17,35,11,41,91,12,37,29,54,18,26,138
Memphis,82,"April 12, 2017",Dallas,1,0,93,100,1,48,93,48,18,4,5,14,23,32,16,33,84,8,25,25,59,19,22,100
L.A. Clippers,82,"April 12, 2017",Sacramento,1,1,115,95,1,48,115,43,29,4,6,6,15,32,11,43,83,10,28,33,55,19,25,145
New York,82,"April 12, 2017",Philadelphia,1,1,114,113,1,48,114,42,17,6,5,20,18,25,17,41,80,9,22,32,58,23,32,116
Dallas,82,"April 12, 2017",Memphis,0,1,100,93,1,48,100,37,21,9,5,12,19,29,8,33,75,9,34,24,41,25,31,112
Denver,82,"April 12, 2017",Oklahoma City,0,1,111,105,1,48,111,43,22,6,8,15,17,38,5,39,85,7,25,32,60,26,32,123
Milwaukee,83,"April 15, 2017",Toronto,0,1,97,83,2,48,97,43,22,5,5,5,23,34,9,38,85,9,23,29,62,12,15,117
Memphis,83,"April 15, 2017",San Antonio,0,0,82,111,2,48,82,35,17,7,7,8,20,27,8,31,79,7,20,24,59,13,17,88
Utah,83,"April 15, 2017",L.A.Clippers,0,1,97,95,2,48,97,34,21,7,4,12,19,28,6,38,79,8,19,30,60,13,19,104
Boston,83,"April 16, 2017",Chicago,1,0,102,106,2,48,102,36,27,9,4,15,20,24,12,37,86,14,38,23,48,14,19,109
Cleveland,83,"April 15, 2017",Indiana,1,1,109,108,2,48,109,34,26,7,3,11,19,24,10,42,78,11,28,31,50,14,27,119
L.A. Clippers,83,"April 15, 2017",Utah,1,0,95,97,2,48,95,40,20,6,4,15,18,32,8,36,81,8,24,28,57,15,17,103
Washington,83,"April 16, 2017",Atlanta,1,1,114,107,2,48,114,42,28,8,9,12,25,27,15,45,100,8,28,37,72,16,17,133
Indiana,83,"April 15, 2017",Cleveland,0,0,108,109,2,48,108,41,21,6,1,13,25,29,12,40,81,11,24,29,57,17,20,120
Portland,83,"April 16, 2017",Golden State,0,0,109,121,2,48,109,38,15,8,3,14,25,27,11,40,93,11,30,29,63,18,22,102
Oklahoma City,83,"April 16, 2017",Houston,0,0,87,118,2,48,87,41,19,8,6,15,19,34,7,30,81,9,29,21,52,18,23,90
Houston,83,"April 16, 2017",Oklahoma City,1,1,118,87,2,48,118,56,21,8,3,11,19,42,14,45,91,10,33,35,58,18,26,141
San Antonio,83,"April 15, 2017",Memphis,1,1,111,82,2,48,111,43,16,4,11,9,20,34,9,41,77,10,19,31,58,19,25,134
Chicago,83,"April 16, 2017",Boston,0,1,106,102,2,48,106,53,22,10,7,16,18,33,20,39,91,8,25,31,66,20,23,127
Golden State,83,"April 16, 2017",Portland,1,1,121,109,2,48,121,45,26,7,10,16,24,36,9,43,81,11,27,32,54,24,28,151
Toronto,83,"April 15, 2017",Milwaukee,1,0,83,97,2,48,83,47,15,3,4,10,21,39,8,27,75,5,23,22,52,24,33,85
Atlanta,83,"April 16, 2017",Washington,0,0,107,114,2,48,107,48,18,5,3,19,22,35,13,34,78,7,25,27,53,32,39,111
L.A. Clippers,84,"April 18, 2017",Utah,1,1,99,91,2,48,99,39,26,7,4,11,23,31,8,44,84,6,20,38,64,5,8,121
Chicago,84,"April 18, 2017",Boston,0,1,111,97,2,48,111,43,28,12,6,10,17,32,11,45,88,10,25,35,63,11,14,144
Boston,84,"April 18, 2017",Chicago,1,0,97,111,2,48,97,38,26,6,4,16,17,27,11,38,82,10,33,28,49,11,19,103
Memphis,84,"April 17, 2017",San Antonio,0,0,82,96,2,48,82,35,19,8,1,8,22,26,9,31,82,7,27,24,55,13,15,84
Portland,84,"April 19, 2017",Golden State,0,0,81,110,2,48,81,47,17,8,7,18,19,36,11,30,90,7,34,23,56,14,19,77
Milwaukee,84,"April 18, 2017",Toronto,0,0,100,106,2,48,100,40,20,6,3,11,16,28,12,36,87,11,23,25,64,17,19,105
Utah,84,"April 18, 2017",L.A.Clippers,0,0,91,99,2,48,91,33,15,7,2,13,16,30,3,32,70,10,25,22,45,17,22,92
Indiana,84,"April 17, 2017",Cleveland,0,0,111,117,2,48,111,33,23,14,3,13,21,24,9,43,84,8,20,35,64,17,23,124
Toronto,84,"April 18, 2017",Milwaukee,1,1,106,100,2,48,106,40,24,6,4,12,22,34,6,37,77,14,29,23,48,18,25,121
Cleveland,84,"April 17, 2017",Indiana,1,1,117,111,2,48,117,37,19,6,8,18,16,30,7,42,76,13,31,29,45,20,23,132
Golden State,84,"April 19, 2017",Portland,1,1,110,81,2,48,110,54,31,8,11,17,17,43,11,40,91,10,32,30,59,20,24,142
Oklahoma City,84,"April 19, 2017",Houston,0,0,111,115,2,48,111,48,20,9,12,7,24,31,17,40,97,7,30,33,67,24,28,132
Washington,84,"April 19, 2017",Atlanta,1,1,109,101,2,48,109,43,22,10,11,11,29,32,11,39,86,7,22,32,64,24,33,128
Houston,84,"April 19, 2017",Oklahoma City,1,1,115,111,2,48,115,37,20,5,8,13,21,32,5,38,78,11,29,27,49,28,37,123
San Antonio,84,"April 17, 2017",Memphis,1,1,96,82,2,48,96,39,14,4,5,14,13,34,5,28,61,9,23,19,38,31,32,110
Atlanta,84,"April 19, 2017",Washington,0,0,101,109,2,48,101,41,17,6,6,18,26,31,10,32,79,4,20,28,59,33,38,101
Boston,85,"April 21, 2017",Chicago,0,1,104,87,2,48,104,37,34,11,2,12,12,30,7,41,86,17,37,24,49,5,7,129
Milwaukee,85,"April 20, 2017",Toronto,1,1,104,77,2,48,104,36,29,6,4,13,25,33,3,39,74,12,23,27,51,14,19,126
Oklahoma City,85,"April 21, 2017",Houston,1,1,115,113,2,48,115,40,24,8,5,11,21,31,9,46,83,9,19,37,64,14,23,135
Chicago,85,"April 21, 2017",Boston,1,0,87,104,2,48,87,52,14,7,8,17,15,37,15,33,84,6,21,27,63,15,15,100
San Antonio,85,"April 20, 2017",Memphis,0,0,94,105,2,48,94,42,16,1,4,12,21,30,12,34,72,10,24,24,48,16,28,95
Washington,85,"April 22, 2017",Atlanta,0,0,98,116,2,48,98,42,16,6,4,15,28,36,6,37,89,7,29,30,60,17,20,96
Memphis,85,"April 20, 2017",San Antonio,1,1,105,94,2,48,105,33,21,2,3,5,24,27,6,39,77,9,22,30,55,18,20,119
Atlanta,85,"April 22, 2017",Washington,1,1,116,98,2,48,116,50,26,6,5,11,17,39,11,44,89,9,25,35,64,19,32,134
Utah,85,"April 21, 2017",L.A.Clippers,1,0,106,111,2,48,106,27,16,5,2,11,26,24,3,36,69,14,34,22,35,20,29,103
Cleveland,85,"April 20, 2017",Indiana,0,1,119,114,2,48,119,40,23,6,8,8,23,32,8,39,87,21,44,18,43,20,30,130
Indiana,85,"April 20, 2017",Cleveland,1,0,114,119,2,48,114,52,25,4,5,9,23,35,17,38,95,16,41,22,54,22,26,130
Portland,85,"April 22, 2017",Golden State,1,0,113,119,2,48,113,52,17,5,6,16,23,41,11,39,90,13,32,26,58,22,27,121
L.A. Clippers,85,"April 21, 2017",Utah,0,1,111,106,2,48,111,41,16,8,3,8,20,32,9,41,75,7,19,34,56,22,33,126
Toronto,85,"April 20, 2017",Milwaukee,0,0,77,104,2,48,77,40,11,6,5,15,21,31,9,24,71,6,22,18,49,23,30,70
Houston,85,"April 21, 2017",Oklahoma City,0,0,113,115,2,48,113,42,10,4,6,13,24,31,11,38,83,10,35,28,48,27,33,111
Golden State,85,"April 22, 2017",Portland,0,1,119,113,2,48,119,42,25,11,11,7,19,36,6,40,91,12,36,28,55,27,35,142
Indiana,86,"April 23, 2017",Cleveland,1,0,102,106,2,48,102,42,21,8,6,14,22,33,9,41,88,10,30,31,58,10,17,111
Milwaukee,86,"April 22, 2017",Toronto,1,0,76,87,2,48,76,50,16,8,3,20,21,37,13,30,81,5,21,25,60,11,18,75
Utah,86,"April 23, 2017",L.A.Clippers,1,1,105,98,2,48,105,42,24,7,3,12,17,35,7,40,74,10,22,30,52,15,21,129
Toronto,86,"April 22, 2017",Milwaukee,0,1,87,76,2,48,87,41,16,11,6,12,19,37,4,33,80,5,22,28,58,16,17,101
San Antonio,86,"April 22, 2017",Memphis,0,0,108,110,2,53,108,37,16,11,3,9,24,29,8,41,97,9,30,32,67,17,17,110
Boston,86,"April 23, 2017",Chicago,0,1,104,95,2,48,104,41,22,7,4,13,24,31,10,38,81,10,37,28,44,18,22,118
Washington,86,"April 24, 2017",Atlanta,0,0,101,111,2,48,101,46,19,7,5,14,25,37,9,36,85,11,32,25,53,18,23,110
Oklahoma City,86,"April 23, 2017",Houston,1,0,109,113,2,48,109,40,20,10,14,17,20,30,10,42,85,7,19,35,66,18,32,119
Atlanta,86,"April 24, 2017",Washington,1,1,111,101,2,48,111,49,24,7,1,12,20,37,12,40,90,12,31,28,59,19,25,124
Golden State,86,"April 24, 2017",Portland,0,1,128,103,2,48,128,45,27,7,9,10,15,39,6,46,86,17,29,29,57,19,27,158
L.A. Clippers,86,"April 23, 2017",Utah,0,0,98,105,2,48,98,31,17,8,0,9,18,25,6,33,75,11,32,22,43,21,29,95
Memphis,86,"April 22, 2017",San Antonio,1,1,110,108,2,53,110,51,19,3,3,22,21,43,8,38,82,12,27,26,55,22,24,118
Cleveland,86,"April 23, 2017",Indiana,0,1,106,102,2,48,106,48,11,9,8,13,15,33,15,37,90,9,31,28,59,23,27,112
Portland,86,"April 24, 2017",Golden State,1,0,103,128,2,48,103,39,14,7,3,11,20,32,7,33,85,13,39,20,46,24,29,98
Chicago,86,"April 23, 2017",Boston,1,0,95,104,2,48,95,44,19,5,4,12,23,32,12,32,76,5,24,27,52,26,33,104
Houston,86,"April 23, 2017",Oklahoma City,0,1,113,109,2,48,113,45,19,13,2,19,26,32,13,37,85,11,35,26,50,28,33,120
Utah,87,"April 25, 2017",L.A.Clippers,0,1,96,92,2,48,96,43,25,10,5,12,24,36,7,35,81,13,36,22,45,13,16,118
Chicago,87,"April 26, 2017",Boston,0,0,97,108,2,48,97,42,24,4,5,16,21,37,5,37,74,9,26,28,48,14,17,116
Atlanta,87,"April 26, 2017",Washington,0,0,99,103,2,48,99,43,23,3,2,11,21,32,11,38,93,9,31,29,62,14,21,97
Milwaukee,87,"April 24, 2017",Toronto,0,0,93,118,2,48,93,23,22,13,4,15,23,21,2,34,68,10,22,24,46,15,26,95
San Antonio,87,"April 25, 2017",Memphis,1,1,116,103,2,48,116,34,23,7,2,7,17,24,10,42,80,14,28,28,52,18,22,133
Golden State,87,"May 2, 2017",Utah,1,1,106,94,2,48,106,37,32,7,8,7,16,32,5,40,82,7,29,33,53,19,21,139
Oklahoma City,87,"April 25, 2017",Houston,0,0,99,105,2,48,99,49,16,7,7,13,27,31,18,35,91,10,38,25,53,19,29,99
Memphis,87,"April 25, 2017",San Antonio,0,0,103,116,2,48,103,31,22,7,1,9,20,23,8,37,72,9,22,28,50,20,22,118
Washington,87,"April 26, 2017",Atlanta,1,1,103,99,2,48,103,42,21,8,10,6,20,33,9,37,82,7,24,30,58,22,27,128
Boston,87,"April 26, 2017",Chicago,1,1,108,97,2,48,108,38,27,9,3,6,16,30,8,38,88,9,40,29,48,23,23,129
Toronto,87,"April 24, 2017",Milwaukee,1,1,118,93,2,48,118,40,28,10,6,17,24,35,5,41,71,12,27,29,44,24,26,153
L.A. Clippers,87,"April 25, 2017",Utah,1,0,92,96,2,48,92,34,16,7,2,13,20,31,3,29,69,10,23,19,46,24,29,93
Cleveland,87,"May 1, 2017",Toronto,1,1,116,105,2,48,116,46,26,8,4,12,18,39,7,39,85,14,34,25,51,24,29,137
Houston,87,"April 25, 2017",Oklahoma City,1,1,105,99,2,48,105,47,13,7,6,12,23,37,10,33,82,6,37,27,45,33,39,111
Boston,88,"April 28, 2017",Chicago,0,1,105,83,2,48,105,43,28,7,5,9,14,36,7,39,80,16,39,23,41,11,18,131
Chicago,88,"April 28, 2017",Boston,1,0,83,105,2,48,83,45,13,5,2,13,16,34,11,32,81,4,19,28,62,15,17,84
L.A. Clippers,88,"April 28, 2017",Utah,0,1,98,93,2,48,98,41,17,5,2,16,24,31,10,37,75,9,21,28,54,15,26,98
Atlanta,88,"April 28, 2017",Washington,1,0,99,115,2,48,99,35,26,9,4,22,22,24,11,37,78,9,32,28,46,16,19,107
Golden State,88,"May 4, 2017",Utah,1,1,115,104,2,48,115,47,33,11,4,17,20,38,9,42,85,14,31,28,54,17,20,147
Milwaukee,88,"April 27, 2017",Toronto,1,0,89,92,2,48,89,38,18,11,10,14,20,26,12,32,76,7,19,25,57,18,28,98
Toronto,88,"April 27, 2017",Milwaukee,0,1,92,89,2,48,92,43,14,9,4,14,20,32,11,32,70,9,22,23,48,19,23,106
Memphis,88,"April 27, 2017",San Antonio,1,0,96,103,2,48,96,28,15,4,1,11,26,21,7,32,71,12,27,20,44,20,24,90
Washington,88,"April 28, 2017",Atlanta,0,1,115,99,2,48,115,33,21,16,7,16,22,25,8,42,78,10,24,32,54,21,25,136
San Antonio,88,"April 27, 2017",Memphis,0,1,103,96,2,48,103,46,13,4,0,12,20,30,16,37,77,7,20,30,57,22,25,111
Utah,88,"April 28, 2017",L.A.Clippers,1,0,93,98,2,48,93,38,18,8,5,7,20,28,10,32,78,7,26,25,52,22,33,98
Houston,88,"May 1, 2017",San Antonio,0,1,126,99,2,48,126,49,30,13,5,14,25,42,7,40,87,22,50,18,37,24,27,159
Cleveland,88,"May 3, 2017",Toronto,1,1,125,103,2,48,125,40,28,9,4,16,22,34,6,41,75,18,33,23,42,25,34,147
Houston,89,"May 3, 2017",San Antonio,0,0,96,121,2,48,96,32,22,7,3,11,18,23,9,37,83,11,34,26,49,11,15,99
Boston,89,"April 30, 2017",Washington,1,1,123,111,2,48,123,38,32,8,7,11,25,26,12,46,90,19,39,27,51,12,15,150
Washington,89,"April 30, 2017",Boston,0,0,111,123,2,48,111,38,27,6,7,12,14,26,12,44,87,10,23,34,64,13,22,125
L.A. Clippers,89,"April 30, 2017",Utah,1,0,91,104,2,48,91,38,17,3,2,10,19,28,10,35,80,6,25,29,55,15,26,85
Toronto,89,"May 1, 2017",Cleveland,0,0,105,116,2,48,105,43,22,5,5,12,22,35,8,39,89,10,26,29,63,17,20,115
Utah,89,"April 30, 2017",L.A.Clippers,0,1,104,91,2,48,104,46,22,8,2,8,24,36,10,40,79,6,13,34,66,18,23,130
Golden State,89,"May 6, 2017",Utah,0,1,102,91,2,48,102,51,17,3,4,7,20,43,8,37,84,9,30,28,54,19,23,119
Cleveland,89,"May 5, 2017",Toronto,0,1,115,94,2,48,115,49,15,2,6,16,20,41,8,39,76,13,23,26,53,24,28,130
San Antonio,89,"May 1, 2017",Houston,1,0,99,126,2,48,99,45,19,10,2,15,18,34,11,31,84,9,29,22,55,28,36,99
Utah,90,"May 2, 2017",Golden State,0,0,94,106,2,48,94,44,25,7,4,13,18,36,8,38,82,9,29,29,53,9,12,114
Toronto,90,"May 3, 2017",Cleveland,0,0,103,125,2,48,103,37,21,8,4,13,21,29,8,42,90,5,17,37,73,14,19,107
Cleveland,90,"May 7, 2017",Toronto,0,1,109,102,2,48,109,36,24,9,5,10,11,31,5,39,82,16,41,23,41,15,16,129
Houston,90,"May 5, 2017",San Antonio,1,0,92,103,2,48,92,39,17,12,7,14,18,25,14,32,88,12,39,20,49,16,18,95
San Antonio,90,"May 3, 2017",Houston,1,1,121,96,2,48,121,47,27,5,7,7,16,32,15,48,88,9,24,39,64,16,18,158
Washington,90,"May 2, 2017",Boston,0,0,119,129,2,53,119,44,28,7,10,17,29,31,13,46,99,10,34,36,65,17,22,133
Golden State,90,"May 8, 2017",Utah,0,1,121,95,2,48,121,50,28,8,3,11,26,44,6,43,84,11,26,32,58,24,27,155
Boston,90,"May 2, 2017",Washington,1,1,129,119,2,53,129,41,26,11,7,16,21,29,12,45,88,13,36,32,52,26,34,147
Houston,91,"May 7, 2017",San Antonio,1,1,125,104,2,48,125,41,28,7,3,9,17,34,7,50,95,19,43,31,52,6,10,146
Toronto,91,"May 5, 2017",Cleveland,1,0,94,115,2,48,94,25,17,9,4,4,21,24,1,38,87,2,18,36,69,16,17,95
Utah,91,"May 4, 2017",Golden State,0,0,104,115,2,48,104,39,19,9,2,14,23,34,5,38,84,12,32,26,52,16,20,109
San Antonio,91,"May 5, 2017",Houston,0,1,103,92,2,48,103,49,23,7,8,20,17,37,12,39,86,9,25,30,61,16,20,119
Washington,91,"May 4, 2017",Boston,1,1,116,89,2,48,116,50,26,7,5,9,26,37,13,43,92,8,25,35,67,22,25,143
Golden State,91,"May 14, 2017",San Antonio,1,1,113,111,2,48,113,43,22,13,8,19,24,26,17,39,81,11,30,28,51,24,33,129
Boston,91,"May 4, 2017",Washington,0,0,89,116,2,48,89,38,20,4,2,16,26,30,8,27,77,10,32,17,45,25,33,79
Cleveland,91,"May 17, 2017",Boston,0,1,117,104,2,48,117,44,21,9,2,8,17,32,12,39,81,11,31,28,50,28,35,136
San Antonio,92,"May 7, 2017",Houston,0,0,104,125,2,48,104,43,23,8,6,14,13,32,11,44,89,7,23,37,66,9,18,116
Toronto,92,"May 7, 2017",Cleveland,1,0,102,109,2,48,102,38,28,7,3,12,18,29,9,40,85,10,29,30,56,12,15,118
Houston,92,"May 9, 2017",San Antonio,0,0,107,110,2,53,107,47,21,4,5,15,23,38,9,38,86,16,48,22,38,15,21,115
Cleveland,92,"May 19, 2017",Boston,0,1,130,86,2,48,130,45,28,10,6,12,17,36,9,48,85,19,39,29,46,15,23,162
Golden State,92,"May 16, 2017",San Antonio,1,1,136,100,2,48,136,40,39,16,5,16,19,34,6,50,89,18,37,32,52,18,19,180
Boston,92,"May 7, 2017",Washington,0,0,102,121,2,48,102,31,28,13,6,18,25,22,9,35,79,14,31,21,48,18,24,112
Washington,92,"May 7, 2017",Boston,1,1,121,102,2,48,121,45,29,13,3,19,22,33,12,44,84,9,21,35,63,24,27,149
Utah,92,"May 6, 2017",Golden State,1,0,91,102,2,48,91,42,19,6,3,8,22,37,5,30,77,7,22,23,55,24,34,96
Boston,93,"May 10, 2017",Washington,1,1,123,101,2,48,123,48,33,7,8,11,25,39,9,46,87,16,33,30,54,15,21,161
San Antonio,93,"May 9, 2017",Houston,1,1,110,107,2,53,110,52,24,7,5,7,18,34,18,42,103,11,33,31,70,15,23,122
Golden State,93,"May 20, 2017",San Antonio,0,1,120,108,2,48,120,42,23,12,6,21,23,33,9,46,84,11,27,35,57,17,22,139
Houston,93,"May 11, 2017",San Antonio,1,0,75,114,2,48,75,37,14,5,3,13,16,27,10,22,77,13,40,9,37,18,25,59
Utah,93,"May 8, 2017",Golden State,1,0,95,121,2,48,95,42,13,7,4,9,23,32,10,33,89,8,27,25,62,21,28,89
Washington,93,"May 10, 2017",Boston,0,0,101,123,2,48,101,45,21,5,5,12,18,29,16,35,91,7,29,28,62,24,29,104
Cleveland,93,"May 21, 2017",Boston,1,0,108,111,2,48,108,46,21,5,5,15,11,35,11,32,70,16,39,16,31,28,36,124
San Antonio,94,"May 11, 2017",Houston,0,1,114,75,2,48,114,60,32,8,9,7,21,46,14,51,96,5,22,46,74,7,13,165
Washington,94,"May 12, 2017",Boston,1,1,92,91,2,48,92,46,20,4,7,12,24,35,11,37,86,5,24,32,62,13,21,100
Cleveland,94,"May 23, 2017",Boston,1,1,112,99,2,48,112,37,23,5,4,14,16,33,4,44,74,10,22,34,52,14,17,134
Boston,94,"May 12, 2017",Washington,0,0,91,92,2,48,91,37,25,5,3,10,19,30,7,32,79,11,35,21,44,16,18,102
Golden State,94,"May 22, 2017",San Antonio,0,1,129,115,2,48,129,53,30,7,3,17,25,48,5,48,86,14,39,34,47,19,25,161
Golden State,95,"June 1, 2017",Cleveland,1,1,113,91,2,48,113,50,31,12,3,4,24,36,14,45,106,12,33,33,73,11,16,139
Cleveland,95,"May 25, 2017",Boston,0,1,135,102,2,48,135,38,24,13,5,11,21,32,6,48,85,19,41,29,44,20,24,163
Boston,95,"May 15, 2017",Washington,1,1,115,105,2,48,115,31,27,7,4,8,24,27,4,42,79,11,26,31,53,20,25,134
Washington,95,"May 15, 2017",Boston,0,0,105,115,2,48,105,43,18,6,4,15,17,33,10,36,80,10,29,26,51,23,29,111
San Antonio,95,"May 14, 2017",Golden State,0,0,111,113,2,48,111,37,19,13,4,17,24,23,14,40,84,7,22,33,62,24,28,119
Boston,96,"May 17, 2017",Cleveland,1,0,104,117,2,48,104,40,33,4,1,14,26,27,13,41,88,12,38,29,50,10,18,113
San Antonio,96,"May 16, 2017",Golden State,0,0,100,136,2,48,100,49,21,11,5,18,17,27,22,37,100,8,23,29,77,18,21,102
Cleveland,96,"June 1, 2017",Golden State,0,0,91,113,2,48,91,59,15,0,6,20,23,44,15,30,86,11,31,19,55,20,25,90
Golden State,96,"June 4, 2017",Cleveland,1,1,132,113,2,48,132,53,34,5,7,20,19,43,10,46,89,18,43,28,46,22,24,166
Boston,97,"May 19, 2017",Cleveland,1,0,86,130,2,48,86,39,23,7,4,20,19,29,10,32,86,8,27,24,59,14,15,84
Cleveland,97,"June 4, 2017",Golden State,0,0,113,132,2,48,113,41,27,15,1,9,18,31,10,45,100,8,29,37,71,15,19,129
San Antonio,97,"May 20, 2017",Golden State,1,0,108,120,2,48,108,46,22,10,3,15,21,31,15,44,93,5,21,39,72,15,25,115
Golden State,97,"June 7, 2017",Cleveland,0,1,118,113,2,48,118,44,29,8,4,18,28,36,8,40,83,16,33,24,50,22,24,140
Boston,98,"May 21, 2017",Cleveland,0,1,111,108,2,48,111,38,28,10,3,9,23,27,11,42,91,18,40,24,51,9,12,129
Cleveland,98,"June 7, 2017",Golden State,1,0,113,118,2,48,113,37,17,9,3,12,25,27,10,40,90,12,44,28,46,21,25,113
San Antonio,98,"May 22, 2017",Golden State,1,0,115,129,2,48,115,42,33,14,4,8,20,30,12,41,98,8,25,33,73,25,32,136
Golden State,98,"June 9, 2017",Cleveland,0,0,116,137,2,48,116,40,26,5,6,12,27,24,16,39,87,11,39,28,48,27,36,124
Boston,99,"May 23, 2017",Cleveland,0,0,99,112,2,48,99,29,26,7,2,12,15,22,7,35,79,10,31,25,48,19,20,106
Cleveland,99,"June 9, 2017",Golden State,1,1,137,116,2,48,137,41,27,6,3,11,24,30,11,46,87,24,45,22,42,21,31,152
Golden State,99,"June 12, 2017",Cleveland,1,1,129,120,2,48,129,42,27,8,2,13,24,29,13,46,90,14,38,32,52,23,28,146
Cleveland,100,"June 12, 2017",Golden State,0,0,120,129,2,48,120,40,22,6,5,14,22,28,12,47,88,11,24,36,64,15,23,130
Boston,100,"May 25, 2017",Cleveland,1,0,102,135,2,48,102,39,20,7,5,18,23,27,12,37,86,11,30,26,56,17,23,100
